Абай	Абай	M
Абайділдан	Абайдильдан	M
Абақан	Абахан	M
Аббас	Аббас	M
Абдан	Абдан	M
Абдол	Абдол	M
Абдолла	Абдулла	M
Абзал	Абзал	M
Абира	Абира	F
Аблақ	Аблак	M
Абыз	Абыз	M
Абылай	Абылай	M
Ағабек	Агабек	M
Ағайша	Агайша	F
Ағамалы	Агамали	M
Ағеділ	Агедиль	M
Ағәділ	Агадиль	M
Ағзам	Агзам	M
Ағила	Агила	F
Ағипа	Агипа	F
Ағлия	Аглия	F
Ағыбай	Агибай	M
Ағыман	Агман	M
Ағын	Агын	M
Ада	Ада	F
Адай	Адай	M
Адайхан	Адайхан	M
Адам	Адам	M
Адамбай	Адамбай	M
Адамбек	Адамбек	M
Адлия	Адлия	F
Адырбай	Адырбай	M
Ажар	Ажар	F
Ажарбек	Ажарбек	M
Ажаргүл	Ажаргуль	F
Ажархан	Ажархан	F
Аза	Аза	F
Азалия	Азалия	F
Азамат	Азамат	M
Азаматша	Азаматша	F
Азат	Азат	M
Азатгүл	Азатгуль	F
Азатия	Азатия	F
Азимат	Азимат	F
Азиха	Азиха	F
Азия	Азия	F
Аида	Аида	F
Айбақан	Айбакан	M
Айбала	Айбала	F
Айбала	Айбала	M
Айбанат	Айбанат	F
Айбану	Айбану	F
Айбар	Айбар	M
Айбарша	Айбарша	F
Айбаршын	Айбаршин	F
Айбас	Айбас	M
Айбат	Айбат	M
Айбейнеш	Айбейнеш	F
Айбек	Айбек	M
Айберген	Айберген	M
Айберді	Айберди	M
Айбәдер	Айбадер	F
Айбәтес	Айбатес	F
Айбибі	Айбиби	F
Айбике	Айбике	F
Айбол	Айбол	M
Айболат	Айболат	M
Айбын	Айбын	M
Айғабыл	Айгабыл	M
Айғайша	Айгайша	F
Айғали	Айгали	M
Айғанша	Айганша	F
Айғаным	Айганым	F
Айғаныс	Айганыс	F
Айгенже	Айгенже	F
Айголқын	Айтолкын	F
Айгүл	Айгуль	F
Айғыз	Айгыз	F
Айдай	Айдай	F
Айдан	Айдан	M
Айдана	Айдана	F
Айдар	Айдар	M
Айдара	Айдара	F
Айдаралы	Айдаралы	M
Айдарбек	Айдарбек	M
Айдарғали	Айдаргали	M
Айдария	Айдария	F
Айдархан	Айдархан	M
Айдәния	Айдания	F
Айдос	Айдос	M
Айдын	Айдын	M
Айдынбек	Айдынбек	M
Айәділ	Айадил	M
Айәділ	Аядиль	M
Айәсем	Айасем	F
Айжайна	Айжайна	F
Айжақсым	Айжаксым	F
Айжамал	Айжамал	F
Айжан	Айжан	F
Айжанар	Айжанар	F
Айжания	Айжания	F
Айжарқын	Айжаркин	M
Айжарық	Айжарик	M
Айжас	Айжас	M
Айжігіт	Айжигит	M
Айжүніс	Айжунис	F
Айжұлдыз	Айжулдыз	F
Айза	Айза	F
Айзада	Айзада	F
Айзар	Айзар	M
Айзара	Айзара	F
Айзат	Айзат	F
Айзат	Айзат	M
Айзейне	Айзейне	F
Айзере	Айзере	F
Айзиба	Айзиба	F
Айзия	Айзия	F
Айкелбет	Айкелбет	F
Айкен	Айкен	F
Айкүміс	Айкумис	F
Айкүн	Айкун	F
Айқын	Айкын	M
Аймағамбет	Аймагамбет	M
Аймаған	Аймаган	M
Аймақ	Аймак	M
Айман	Айман	F
Айман	Айман	M
Айманай	Айманай	F
Аймангүл	Аймангуль	F
Айманкүл	Айманкуль	F
Аймат	Аймат	M
Аймауыт	Аймаут	M
Аймаш	Аймаш	F
Аймәрия	Аймария	F
Аймира	Аймира	F
Аймұқамбет	Аймухамбет	M
Аймұрат	Аймурат	M
Аймырза	Аймурза	M
Айна	Айна	F
Айнабек	Айнабек	M
Айнагүл	Айнагуль	F
Айназия	Айназия	F
Айнакүл	Айнакуль	F
Айнақан	Айнахан	F
Айнаш	Айнаш	F
Айнаша	Айнаша	F
Айнет	Айнет	M
Айниса	Айниса	F
Айнұр	Айнур	F
Айнұра	Айнура	F
Айнұрия	Айнурия	F
Айпар	Айпар	M
Айпара	Айпара	F
Айрат	Айрат	M
Айрықша	Айрыкша	F
Айса	Айса	M
Айсара	Айсара	F
Айсары	Айсари	M
Айсауыт	Айсауыт	M
Айсауыт	Айсаут	M
Айсәуле	Айсауле	F
Айсипат	Айсипат	F
Айсүгір	Айсугир	M
Айсүгір	Айсугур	M
Айсұлу	Айсулу	F
Айт	Айт	M
Айтаза	Айтаза	M
Айтақ	Айтак	M
Айтақын	Айтакын	M
Айтан	Айтан	M
Айтания	Айтания	F
Айтас	Айтас	M
Айтбай	Айтбай	M
Айтбала	Айтбала	F
Айтдана	Айтдана	F
Айтемір	Айтемир	M
Айтәлі	Айтали	M
Айтжамал	Айтжамал	F
Айтжан	Айтжан	M
Айтілеу	Айтлеу	M
Айтқали	Айткали	M
Айтқожа	Айтхожа	M
Айтқожан	Айтхожан	M
Айтқұл	Айткул	M
Айтмағамбет	Айтмагамбет	M
Айтмұқамбет	Айтмухамбет	M
Айтолды	Айтолды	F
Айтолыс	Айтолыс	F
Айту	Айту	M
Айтуар	Айтуар	M
Айтуған	Айтуган	M
Айтық	Айтык	M
Айтым	Айтым	M
Айша	Айша	F
Айшагүл	Айшагуль	F
Айшайым	Айшайым	F
Айшахан	Айшахан	F
Айшолпан	Айшолпан	F
Айшуақ	Айшуак	M
Айшық	Айшик	M
Айшым	Айшим	F
Айшынбай	Айшинбай	M
Айым	Айым	F
Айымбет	Аймбет	M
Айымбибі	Айымбиби	F
Айымбике	Айымбике	F
Айымгүл	Айымгуль	F
Айымжан	Айымжан	F
Айымша	Айымша	F
Акұштап	Акуштап	F
Акылбек	Акылбек	M
Ақабай	Ахабай	M
Ақай	Акай	M
Ақайша	Акайша	F
Ақалтын	Акалтын	F
Ақан	Ахан	M
Ақару	Акару	F
Ақбай	Акбай	M
Ақбала	Акбала	F
Ақбау	Акбау	M
Ақбаян	Акбаян	F
Ақберген	Акберген	M
Ақберді	Акберды	M
Ақбет	Акбет	F
Ақбәтес	Акбатес	F
Ақбәтима	Акбатима	F
Ақбибі	Акбиби	F
Ақбике	Акбике	F
Ақбілек	Акбилек	F
Ақболат	Акболат	M
Ақбота	Акбота	F
Ақбота	Акбота	M
Ақбөкен	Акбокен	F
Ақгүл	Акгуль	F
Ақділда	Акдильда	M
Ақеділ	Акедил	M
Ақерке	Акерке	F
Ақжамал	Акжамал	F
Ақжан	Акжан	F
Ақжан	Акжан	M
Ақжарқын	Акжаркин	M
Ақжелек	Акжелек	F
Ақжеміс	Акжемис	F
Ақжібек	Акжибек	F
Ақжігіт	Акжигит	M
Ақжол	Акжол	M
Ақжүніс	Акжунис	F
Ақжүрек	Акжурек	F
Ақжұпар	Акжупар	F
Ақзейнеп	Акзейнеп	F
Ақзейнет	Акзейнет	F
Ақзер	Акзер	F
Ақзиба	Акзиба	F
Ақзила	Акзила	F
Ақзия	Акзия	F
Ақзия	Акзия	M
Ақкенже	Аккенже	F
Ақкүміс	Аккумис	F
Аққағаз	Аккагаз	F
Аққал	Аккал	F
Аққал	Аккал	M
Аққатша	Аккатша	F
Аққожа	Аккожа	M
Аққозы	Аккозы	M
Аққошқар	Аккошкар	M
Аққу	Акку	F
Аққұба	Аккуба	F
Аққыз	Аккыз	F
Ақлима	Аклима	F
Ақмағамбет	Акмагамбет	M
Ақмамбет	Акмамбет	M
Ақмарал	Акмарал	F
Ақмаржан	Акмаржан	F
Ақмарқа	Акмарха	F
Ақмұқамбет	Акмухамбет	M
Ақнәзия	Акназия	F
Ақнәзік	Акназик	F
Ақниет	Акниет	F
Ақния	Акния	F
Ақпанбет	Акпанбет	M
Ақсазан	Аксазан	F
Ақсана	Аксана	F
Ақсаң	Аксан	F
Ақселеу	Акселеу	M
Ақсұлтан	Аксултан	M
Ақсұлу	Аксулу	F
Ақсыйық	Аксыик	M
Ақтай	Актай	M
Ақтайлақ	Актайлак	M
Ақтал	Актал	M
Ақтамақ	Актамак	F
Ақтамақ	Актамак	M
Ақтан	Ахтан	M
Ақтаң	Актан	M
Ақтілек	Актилек	M
Ақтілек	Актлек	M
Ақтоқты	Актокты	F
Ақтолқын	Актолкын	F
Ақтолық	Актолык	F
Ақтолыс	Актолыс	F
Ақша	Акша	F
Ақшабақ	Ақшабақ	F
Ақшолас	Акшолас	M
Ақшолпан	Ақшолпан	F
Ақшора	Акшора	M
Ақшыбық	Акшибык	F
Ақық	Акык	F
Ақылбай	Акылбай	M
Ақылбек	Акылбек	M
Ақылима	Аклима	F
Ақын	Акын	M
Ақынәлі	Акынали	M
Ақынжан	Акынжан	M
Ақырап	Акырап	M
Ақыш	Акиш	M
Алай	Алай	M
Алапа	Алапа	F
Алатау	Алатау	M
Алау	Алау	M
Албан	Албан	M
Албат	Албат	M
Алға	Алга	M
Алғазы	Алгази	M
Алғатай	Алгатай	M
Алғыр	Алгыр	M
Алғыр	Алгир	M
Алдаберген	Алдаберген	M
Алдадос	Алдадос	M
Алдамжар	Алдамжар	M
Алдамұрат	Алдамурат	M
Алдан	Алдан	M
Алдар	Алдар	M
Алдаш	Алдаш	M
Алжанбай	Алжанбай	M
Алина	Алина	F
Алқа	Алка	F
Алқа	Алка	M
Алқагүл	Алкагуль	F
Алла	Алла	F
Алма	Алма	F
Алмабай	Алмабай	M
Алмабек	Алмабек	M
Алмабике	Алмабике	F
Алмагүл	Алмагуль	F
Алмажан	Алмажан	F
Алмазия	Алмазия	F
Алманияз	Алманияз	M
Алмас	Алмас	M
Алмасбай	Алмасбай	M
Алмасбек	Алмасбек	M
Алмаскүл	Алмаскуль	F
Алмасқан	Алмасхан	M
Алмаша	Алмаша	F
Алмұрт	Алмурт	M
Алпамыс	Алпамыс	M
Алпан	Алпан	M
Алпар	Алпар	M
Алпыс	Алпыс	M
Алпысбай	Алпысбай	M
Алтай	Алтай	M
Алтайбай	Алтайбай	M
Алтайбек	Алтайбек	M
Алтыбай	Алтыбай	M
Алтын	Алтын	F
Алтынай	Алтынай	F
Алтынбай	Алтынбай	M
Алтынбек	Алтынбек	M
Алтынбике	Алтынбике	F
Алтынгүл	Алтынгуль	F
Алтынзер	Алтынзер	F
Алтынсары	Алтынсары	M
Алтыншаш	Алтыншаш	F
Алуа	Алуа	F
Алша	Алша	F
Алшағыр	Алшагир	M
Алшан	Алшан	M
Алшынбай	Алшинбай	M
Алыбай	Алыбай	M
Альбина	Альбина	F
Аман	Аман	F
Аман	Аман	M
Аманай	Аманай	F
Аманат	Аманат	M
Аманбай	Аманбай	M
Аманбала	Аманбала	F
Аманбек	Аманбек	M
Аманболат	Аманболат	M
Аманғали	Амангали	M
Амангелді	Амангельды	M
Амангүл	Амангуль	F
Амандос	Амандос	M
Амандық	Амандык	M
Аманәлі	Аманали	M
Аманжан	Аманжан	M
Аманжол	Аманжол	M
Амания	Амания	F
Аманкеш	Аманкеш	F
Аманқос	Аманкос	M
Амантай	Амантай	M
Амантұр	Амантур	M
Аманша	Аманша	F
Аманшы	Аманши	M
Амрэта	Амрэта	F
Анай	Анай	M
Анар	Анар	F
Анара	Анара	F
Анарбай	Анарбай	M
Анарбек	Анарбек	M
Анаргүл	Анаргуль	F
Анаржан	Анаржан	F
Анархан	Анархан	F
Анас	Анас	M
Анасбек	Анасбек	M
Анасия	Анасия	F
Андас	Андас	M
Анжела	Анжела	F
Аниса	Аниса	F
Анна	Анна	F
Ануза	Ануза	F
Анфиса	Анфиса	F
Аңдамас	Андамас	M
Аңсаған	Ансаган	M
Аңсар	Ансар	M
Аппақ	Аппак	M
Арабай	Арабай	M
Арагония	Арагония	F
Арай	Арай	M
Арайша	Арайша	F
Аралбай	Аралбай	M
Арбек	Арбек	M
Арбол	Арбол	M
Арғын	Аргын	M
Арғынбай	Аргынбай	M
Арда	Арда	F
Ардақ	Ардак	F
Ардақ	Ардак	M
Ардан	Ардан	M
Ардат	Ардат	M
Арзада	Арзада	F
Арзейне	Арзейне	F
Арзиба	Арзиба	F
Арзия	Арзия	F
Арзу	Арзу	F
Арзымбет	Арзымбет	M
Арина	Арина	F
Арқабай	Аркабай	M
Арқалық	Аркалык	M
Арқат	Аркат	M
Арман	Арман	M
Арман	Каумбек	M
Армат	Армат	M
Арна	Арна	F
Арнагүл	Ариагуль	F
Артық	Артык	M
Ару	Ару	F
Арубике	Арубике	F
Аруша	Аруша	F
Аршагүл	Аршагуль	F
Аршат	Аршат	F
Арық	Арык	M
Арықбай	Арыкбай	M
Арықтай	Арыктай	M
Арын	Арын	M
Арынгүл	Арынгуль	F
Арындық	Арындык	M
Арыс	Арыс	M
Арысбай	Арысбай	M
Арыстан	Арыстан	M
Арыстанбай	Арыстанбай	M
Арыстанбек	Арыстанбек	M
Арыстанғали	Арыстангали	M
Асабай	Асабай	M
Асайын	Асаин	M
Асан	Асан	M
Асаналы	Асаналы	M
Асанбай	Асанбай	M
Асанбек	Асанбек	M
Асанғали	Асангали	M
Асанәлі	Асанали	M
Асанхан	Асанхан	M
Асия	Асия	F
Асқар	Аскар	M
Асқарбай	Аскарбай	M
Асқарбек	Аскарбек	M
Асли	Асли	F
Аслима	Аслима	F
Аслия	Аслия	F
Аспазия	Аспазия	F
Аспара	Аспара	F
Астам	Астам	M
Астасия	Астасия	F
Асфандияр	Асфандияр	M
Асхат	Асхат	M
Асықбай	Асыкбай	M
Асыл	Асыл	F
Асыл	Асыл	M
Асылай	Асылай	F
Асылбай	Асылбай	M
Асылбек	Асылбек	M
Асылбике	Асылбике	F
Асылғожа	Асылгожа	M
Асылгүл	Асылгуль	F
Асылжан	Асылжан	F
Асылжан	Асылжан	M
Асылзада	Асылзада	F
Асылима	Асылима	F
Асылмұрат	Асылмурат	M
Асылтаң	Асылтан	F
Асылтас	Асылтас	F
Асылхан	Асылхан	M
Асылша	Асылша 	F
Атабай	Атабай	M
Атабек	Атабек	M
Атай	Атай	M
Атақан	Атахан	M
Аталық	Аталык	M
Атамбек	Атамбек	M
Атамқұл	Атамкул	M
Атамұрат	Атамурат	M
Атанбай	Атанбай	M
Атанияз	Атанияз	M
Атантай	Атантай	M
Атас	Атас	M
Атшабар	Атшабар	M
Атығай	Атыгай	M
Атым	Атим	M
Атымтай	Атымтай	M
Ауғанбай	Ауганбай	M
Аухади	Аухади	M
Ахат	Ахат	M
Ахим	Ахим	M
Ахмеди	Ахмеди	M
Ахмет	Ахмет	M
Ахметбай	Ахметбай	M
Ахметбек	Ахметбек	M
Ахметәлі	Ахметали	M
Ахметжан	Ахметжан	M
Ахметияр	Ахметияр	M
Ахметқали	Ахметкали	M
Ахметолла	Ахметулла	M
Ахметхан	Ахметхан	M
Ахметші	Ахметчи	M
Ахтамберді	Ахтамберды	M
Ашай	Ашай	M
Ашамбай	Ашамбай	M
Аэлита	Аэлита	F
Аюхан	Аюхан	M
Аяжан	Аяжан	F
Аяз	Аяз	M
Аязбай	Аязбай	M
Аязбек	Аязбек	M
Аян	Аян	M
Аянат	Аянат	F
Аяндық	Аяндык	M
Аяп	Аяп	M
Аяпберген	Аяпберген	M
Бабағали	Бабагали	M
Бабажан	Бабажан	M
Бабай	Бабай	M
Бабақ	Бабак	M
Бабалық	Бабалык	M
Бабамұрат	Бабамурат	M
Бабанар	Бабанар	M
Бабанияз	Бабанияз	M
Бабас	Бабас	M
Бабасал	Бабасал	M
Бабатай	Бабатай	M
Бабахан	Бабахан	M
Бағай	Багай	M
Бағашар	Багашар	M
Бағдар	Багдар	M
Бағдат	Багдат	F
Бағдат	Багдат	M
Бағила	Багила	F
Бағлан	Баглан	M
Бағыбай	Багыбай	M
Бағыбек	Багыбек	M
Бағызбай	Багызбай	M
Бағымша	Багымша	F
Бағымша	Багимша	F
Бадам	Бадам	M
Бадамбай	Бадамбай	M
Бадамбек	Бадамбек	M
Баданай	Баданай	F
Баден	Баден	F
Бадыр	Бадыр	M
Бажтай	Бажтай	M
Базай	Базай	M
Базан	Базан	M
Базар	Базар	M
Базарайым	Базарайым	F
Базарайым	Базараим	F
Базаралы	Базаралы	M
Базарбай	Базарбай	M
Базарбек	Базарбек	M
Базарғали	Базаргали	M
Базаргелді	Базаргельды	M
Базаргүл	Базаргуль	F
Базен	Базен	M
Базігүл	Базигуль	F
Базыл	Базыл	M
Базым	Базым	M
Бай	Бай	M
Байарыстан	Байарыстан	M
Байахмет	Байахмет	M
Байбағыс	Байбагыс	M
Байбақ	Байбак	M
Байбақты	Байбакты	M
Байбала	Байбала	M
Байбарыс	Байбарыс	M
Байбатыр	Байбатыр	M
Байбек	Байбек	M
Байбоз	Байбоз	M
Байбол	Байбол	M
Байболат	Байболат	M
Байболды	Байболды	M
Байбосын	Байбосун	M
Байбота	Байбота	M
Байбөрі	Байбори	M
Байбура	Байбура	M
Байғабыл	Байгабыл	M
Байғазы	Байгазы	M
Байғали	Байгали	M
Байғанат	Байганат	M
Байғани	Байгани	M
Байғара	Байгара	M
Байғатар	Байгатар	M
Байгелді	Байгельды	M
Байгенже	Байгенже	M
Байғожа	Байгожа	M
Байғұт	Байгут	M
Байдабек	Байдабек	M
Байдалы	Байдалы	M
Байдар	Байдар	M
Байдаш	Байдаш	M
Байдәулет	Байдаулет	M
Байділда	Байдильда	M
Байдос	Байдос	M
Байжан	Байжан	M
Байжарас	Байжарас	M
Байжігіт	Байжигит	M
Байжол	Байжол	M
Байжомарт	Байжомарт	M
Байзақ	Байзак	M
Байкен	Байкен	M
Байкенес	Байкенес	M
Байқазақ	Байказах	M
Байқоңыр	Байконур	M
Байқошқар	Байкошкар	M
Байқуат	Байкуат	M
Байқұт	Байкут	M
Байқұтты	Байкутты	M
Байлы	Байлы	M
Баймағамбет	Баймагамбет	M
Баймади	Баймади	M
Баймақан	Баймахан	M
Байман	Байман	M
Байманбек	Байманбек	M
Баймат	Баймат	M
Байматай	Байматай	M
Баймен	Баймен	M
Байменді	Байменды	M
Баймолда	Баймолда	M
Баймұқамбет	Баймухамбет	M
Баймұқан	Баймукан	M
Баймұрат	Баймурат	M
Баймырза	Баймурза	M
Байназар	Байназар	M
Байнұр	Байнур	M
Байсал	Байсал	M
Байсалық	Байсалык	M
Байсан	Байсан	M
Байсар	Байсар	M
Байсеиіт	Байсеит	M
Байсерке	Байсерке	M
Байтақ	Байтак	M
Байтан	Байтан	M
Байтана	Байтана	M
Байтас	Байтас	M
Байтелі	Байтели	M
Байтемір	Байтемир	M
Байтерек	Байтерек	M
Байтоғай	Байтугай	M
Байтоқ	Байток	M
Байту	Байту	M
Байтуған	Байтуган	M
Байтур	Байтур	M
Байтұр	Байтур	M
Байтұрсын	Байтурсын	M
Байұзақ	Байузак	M
Байша	Байша	M
Байшағыр	Байшагир	M
Байшы	Байши	M
Байшыған	Байшиган	M
Байшынар	Байчинар	M
Байызбек	Байызбек	M
Байымбет	Баймбет	M
Байынқол	Байынкол	M
Байыр	Баир	M
Байырқас	Баиркас	M
Байыс	Баис	M
Бақай	Бакай	M
Бақау	Бакау	M
Бақбек	Бакбек	M
Бақберген	Бакберген	M
Бақдәулет	Бакдаулет	M
Бақи	Бахи	M
Бақижан	Бахижан	M
Баққожа	Баккожа	M
Баққуат	Баккуат	M
Бақталап	Бакталап	M
Бақтарай	Бактарай	M
Бақтияр	Бахтияр	M
Бақтыбай	Бактыбай	M
Бақтыгерей	Бахтыгерей	M
Бақтыгүл	Бактыгуль	F
Бақтыжар	Бактыжар	M
Бақша	Бакша	F
Бақшагүл	Бакшагуль	F
Бақыт	Бахыт	M
Бақыт	Бакыт	M
Бақытжамал	Бакытжамал	F
Бақытжан	Бахытжан	M
Бақытжан	Бакытжан	M
Балабай	Балабай	M
Балабек	Балабек	M
Балай	Балай	F
Балайым	Балаим	F
Балақаз	Балагаз	M
Балақай	Балакай	M
Баламер	Баламер	M
Баламұрат	Баламурат	M
Балапан	Балапан	M
Балауса	Балауса	F
Балауса	Балауса	M
Балахмет	Балахмет	M
Балбала	Балбала	F
Балбек	Балбек	M
Балбике	Балбике	F
Балбыр	Балбыр	M
Балғабай	Балгабай	M
Балғабек	Балгабек	M
Балғадиша	Балхадиша	F
Балғазы	Балгазы	M
Балғайша	Балгайша	F
Балғаным	Балганым	F
Балғатша	Балгатша	F
Балғожа	Балгожа	M
Балгүл	Балгуль	F
Балғыз	Балгыз	F
Балғымбай	Балгимбай	M
Балғын	Балгын	F
Балғынша	Балгынша	F
Балдай	Балдай	F
Балдос	Балдос	M
Балерке	Балерке	F
Балжан	Балжан	F
Балзада	Балзада	F
Балзия	Балзия	F
Балиша	Балиша	F
Балкүміс	Балкумис	F
Балқадиша	Балкадиша	F
Балқия	Балхия	F
Балқуат	Балкуат	M
Балқы	Балкы	M
Балқы	Балки	M
Балқыбай	Балкибай	M
Балқыбек	Балкибек	M
Балмағамбет	Балмагамбет	M
Балман	Балман	M
Балмұқан	Балмукан	M
Балмұхамбет	Балмухамбет	M
Балнұр	Балнур	F
Балта	Балта	M
Балтабай	Балтабай	M
Балтабан	Балтабан	M
Балтабек	Балтабек	M
Балтазар	Балтазар	M
Балтан	Балтан	M
Балташ	Балташ	M
Балуан	Балуан	M
Балуанғали	Балуангали	M
Балшекер	Балшекер	F
Балым	Балым	F
Балымша	Балымша	F
Банана	Банана	F
Банат	Банат	F
Баниғат	Банигат	M
Бану	Бану	F
Бапа	Бапа	M
Бапай	Бапай	M
Бапы	Бапы	M
Барат	Барат	M
Баржақсы	Баржаксы	M
Бари	Бари	M
Барлыбай	Барлыбай	M
Барлық	Барлык	M
Бармақ	Бармак	M
Барманқұл	Барманкул	M
Барсақ	Барсак	M
Барша	Барша	F
Баршагүл	Баршагуль	F
Баршын	Баршин	F
Баршынай	Баршинай	F
Барыс	Барыс	M
Барысбек	Барсбек	M
Басан	Басан	M
Басар	Басар	M
Басбай	Басбай	M
Басқан	Баскан	M
Бастау	Бастау	M
Бастаубай	Бастаубай	M
Басым	Басым	M
Батай	Батай	M
Батсайы	Батсайы	F
Батсайы	Батсайы	M
Баттал	Баттал	M
Батыр	Батыр	M
Батыралы	Батырали	M
Батыраш	Батыраш	M
Батырбай	Батырбай	M
Батырбек	Батырбек	M
Батыржан	Батыржан	M
Батырқан	Батыркан	M
Батырлан	Батырлан	M
Батырұлан	Батырулан	M
Батырхан	Батырхан	M
Батырша	Батырша	M
Баубек	Баубек	M
Баукен	Баукен	M
Бауыржан	Бауыржан	M
Бафа	Бафа	M
Башан	Башан	M
Баязит	Баязит	M
Баян	Баян	F
Баян	Баян	M
Баянбай	Баянбай	M
Баянды	Баянды	M
Баянсұлу	Баянсулу	F
Баят	Баят	M
Бегайдар	Бегайдар	M
Бегайым	Бегайм	F
Бегалы	Бегали	M
Бегділда	Бегдильда	M
Бегей	Бегей	M
Беген	Беген	M
Бегендік	Бегендик	M
Бегеш	Бегеш	M
Бегім	Бегим	M
Бегімбай	Бегимбай	M
Бегімбет	Бегимбет	M
Бегімсал	Бегимсал	M
Бегіш	Бегиш	M
Беделбай	Беделбай	M
Беделбай	Бедельбай	M
Беделбек	Бедельбек	M
Беделжан	Бедельжан	M
Беделқан	Бедельхан	M
Беден	Беден	M
Бекет	Бекет	M
Бейбіт	Беибит	M
Бейбітгүл	Бейбитгуль	F
Бейбітжан	Бейбитжан	M
Бейіл	Беил	M
Бейімбет	Беимбет	M
Бейіс	Беис	M
Бейісәлі	Беисали	M
Бейқұт	Бейкут	M
Бейнеш	Бейнеш	F
Бейсебай	Бейсебай	M
Бейсебек	Бейсебек	M
Бейсек	Бейсек	M
Бейсекеи	Бейсекей	M
Бейсенбай	Бейсенбай	M
Бейсенбі	Бейсенби	M
Бейсенәлі	Бейсенали	M
Бейсеу	Бейсеу	M
Бейхан	Бейхан	M
Бекайдар	Бекайдар	M
Бекбай	Бекбай	M
Бекбатыр	Бекбатыр	M
Бекбау	Бекбау	M
Бекберген	Бекберген	M
Бекберді	Бекберды	M
Бекбол	Бекбол	M
Бекболат	Бекболат	M
Бекбосын	Бекбосын	M
Бекдайыр	Бекдаир	M
Бекдана	Бекдана	F
Бекебай	Бекебай	M
Бекежан	Бекежан	M
Бекей	Бекей	M
Бекей	Бекей	F
Бекембай	Бекембай	M
Бекен	Бекен	M
Бекетай	Бекетай	M
Бекеш	Бекеш	M
Бекжан	Бекжан	M
Бекжасар	Бекжасар	M
Бекжігіт	Бекжигит	M
Бекзада	Бекзада	F
Бекзат	Бекзат	F
Бекзат	Бекзат	M
Бекзия	Бекзия	F
Бекін	Бекин	M
Бекіш	Бекиш	M
Беккелді	Беккелди	M
Беккелді	Беккелды	M
Бекқали	Беккали	M
Бекқожа	Бекхожа	M
Беклан	Беклан	M
Бекмағамбет	Бекмагамбет	M
Бекман	Бекман	M
Бекмұрат	Бекмурат	M
Бекмұхамбет	Бекмухамбет	M
Бекназ	Бекназ	F
Бекназар	Бекназар	M
Бекнар	Бекнар	M
Бекнияз	Бекнияз	M
Бекпар	Бекпар	M
Бекпембет	Бекпембет	M
Бексана	Бексана	F
Бексейіт	Бексеит	M
Бексұлтан	Бексултан	M
Бексұлу	Бексулу	F
Бектай	Бектай	M
Бектас	Бектас	M
Бектау	Бектау	M
Бектемір	Бектемир	M
Бектеміс	Бектемис	M
Бектен	Бектен	M
Бектібай	Бектибай	M
Бектілеу	Бектилеу	M
Бектілеу	Бектлеу	M
Бектұр	Бектур	M
Бектұрған	Бектурган	M
Бектұрсын	Бектурсын	M
Беласар	Беласар	M
Беласыл	Беласыл	M
Белбай	Бельбай	M
Белберді	Белберди	M
Белбота	Белбота	M
Белгемер	Белгемер	M
Белгібай	Белгибай	M
Белекей	Белекей	M
Белес	Белес	M
Белібай	Белибай	M
Белла	Белла	F
Берғали	Бергали	M
Берген	Берген	M
Берден	Берден	M
Бердәлі	Бердали	M
Бердияр	Бердияр	M
Берді	Берди	M
Бердібай	Бердибай	M
Бердікен	Бердикен	M
Бердімұрат	Бердимурат	M
Береке	Береке	M
Береке	Береке	F
Берекет	Берекет	M
Берен	Берен	M
Бержан	Бержан	M
Берік	Берик	M
Берікбай	Берикбай	M
Беріл	Берил	M
Берістен	Беристен	M
Беріш	Бериш	M
Беркей	Беркей	M
Беркін	Беркин	M
Беркінбай	Беркинбай	M
Берқайыр	Беркаир	M
Бернар	Бернар	M
Бернияз	Бернияз	M
Берта	Берта	F
Бесбай	Бесбай	M
Бәбек	Бабек	M
Бәдер	Бадер	F
Бәдеш	Бадеш	F
Бәди	Бади	M
Бәдиға	Бадига	F
Бәдинұр	Бадинур	F
Бәдиша	Бадиша	F
Бәдия	Бадия	F
Бәдігүлжамал	Бадигульжамал	F
Бәдіғұл	Бадигул	M
Бәдірлен	Бадрлен	M
Бәжен	Бажен	M
Бәзила	Базила	F
Бәйдір	Байдир	M
Бәйіш	Байш	M
Бәйтен	Байтен	M
Бәйтік	Байтик	M
Бәкей	Бакей	M
Бәкен	Бакен	M
Бәки	Баки	M
Бәкизат	Бакизат	F
Бәкиша	Бакиша	F
Бәкия	Бакия	F
Бәкібай	Бакибай	M
Бәкібала	Бакибала	F
Бәкізе	Бакизе	F
Бәкір	Бакир	M
Бәлиға	Балига	F
Бәлия	Балия	F
Бәрімбек	Баримбек	M
Бәсен	Басен	M
Бәсібек	Басибек	M
Бәтен	Батен	F
Бәтес	Батес	F
Бәтиза	Батиза	F
Бәтиқа	Батиха	F
Бәтима	Батима	F
Бәтия	Батия	F
Бәшір	Башир	M
Биахмет	Биахмет	M
Бибагүл	Бибагуль	F
Бибайша	Бибайша	F
Бибатыр	Бибатыр	M
Бибі	Биби	F
Бибіғайша	Бибигайша	F
Бибігүл	Бибигуль	F
Бибіжамал	Бибижамал	F
Бибіжан	Бибижан	F
Бибізада	Бибизада	F
Бибікәмила	Бибикамила	F
Бибіқан	Бибикан	F
Бибінұр	Бибинур	F
Бибісара	Бибисара	F
Бибіханым	Бибиханым	F
Бибіш	Бибиш	F
Биғайша	Бигайша	F
Биғалым	Бигалим	M
Биғаным	Биганым	F
Биғарипа	Бигарипа	F
Бигелді	Бигельды	M
Бидайбек	Бидайбек	M
Биәлі	Биали	M
Бижамал	Бижамал	F
Бижан	Бижан	M
Бижания	Бижания	F
Бизак	Бизак	M
Бизат	Бизат	M
Бизәуре	Бизауре	F
Бике	Бике	F
Бикенай	Бикенай	F
Бимағамбет	Бимагамбет	M
Бимақан	Бимахан	M
Биман	Биман	M
Бимет	Бимет	M
Биржан	Биржан	M
Бисәли	Бисали	M
Битай	Битай	M
Битан	Битан	M
Бияш	Бияш	M
Білгір	Бильгир	M
Біләл	Билял	M
Білжан	Бильжан	M
Білім	Билим	M
Білімқан	Билимкан	F
Білісбай	Билисбай	M
Біржан	Биржан	M
Бірімжан	Биримжан	M
Біркен	Биркен	M
Бірман	Бирман	M
Бітім	Бтим	M
Бодан	Бодан	M
Бодаубай	Бодаубай	M
Бодық	Бодык	M
Бозай	Бозай	M
Бозбай	Бозбай	M
Боздақ	Боздак	M
Бозжан	Бозжан	M
Бозжігіт	Бозжигит	M
Бозтай	Бозтай	M
Бозымбай	Бозымбай	M
Бозымбек	Бозымбек	M
Болат	Болат	M
Болатбек	Болатбек	M
Болатжан	Болатжан	M
Болатқожа	Болаткожа	M
Болатқожа	Болатхожа	M
Болатхан	Болатхан	M
Болған	Болган	M
Болғанбай	Болганбай	M
Болкен	Болкен	M
Болсынай	Болсынай	F
Болсынбек	Болсынбек	M
Бопа	Бопа	F
Бопажан	Бопажан	F
Боран	Боран	M
Боранбай	Боранбай	M
Боранғазы	Борангазы	M
Бораншы	Боранши	M
Бораш	Бораш	M
Борғазы	Боргазы	M
Бортай	Бортай	M
Бота	Бота	F
Ботабай	Ботабай	M
Ботагөз	Ботагоз	F
Ботажан	Ботажан	F
Ботай	Ботай	M
Ботакөз	Ботакоз	F
Ботан	Ботан	M
Ботанбек	Ботанбек	M
Боташ	Боташ	M
Ботбай	Ботбай	M
Бошай	Бошай	M
Бошан	Бошан	M
Боштай	Боштай	M
Бөбей	Бубей	M
Бөбей	Бобей	M
Бөбет	Бубет	M
Бөбет	Бобет	M
Бөден	Буден	M
Бөден	Боден	M
Бөдеш	Бодеш	M
Бөжей	Божей	M
Бөкей	Бокей	M
Бөкен	Бокен	F
Бөкенбай	Бокенбай	M
Бөле	Боле	M
Бөлебай	Болебай	M
Бөлтірік	Бультрик	M
Бөрі	Бори	M
Бөрібай	Борибай	M
Бурабай	Бурабай	M
Бурақан	Бурахан	M
Бураш	Бураш	M
Бүбайша	Бубайша	F
Бүбиша	Бубиша	F
Бүбі	Буби	F
Бүбіхан	Бубихан	F
Бүбіш	Бубиш	F
Бүбішайым	Бубишаим	F
Бүке	Буке	M
Бүлабай	Булабай	M
Бүлде	Бульде	F
Бүлдіршін	Булдиршин	F
Бүлдіршін	Бульдиршин	F
Бүркіт	Буркит	M
Бүркіт	Буркут	M
Бүркітбай	Буркутбай	M
Бүрлібай	Бурлибай	M
Бұғыбай	Бугыбай	M
Бұғыбай	Бугубай	M
Бұқас	Букас	M
Бұлабай	Булабай	M
Бұлақбай	Булакбай	M
Бұланбай	Буланбай	M
Бұлбұл	Булбул	F
Бұлдыбай	Булдыбай	M
Бұлжан	Булжан	F
Бұлқыш	Булкыш	M
Бұлқыш	Булкиш	M
Бұрхан	Бурхан	M
Бұрхат	Бурхат	M
Бұхар	Бухар	M
Бұхарбай	Бухарбай	M
Бэтила	Батила	F
Валентина	Валентина	F
Венера	Венера	F
Вера	Вера	F
Вилора	Вилора	F
Влада	Влада	F
Ғаббас	Габбас	M
Ғабдиман	Габдиман	M
Ғабдолла	Габдулла	M
Ғабдыр	Габдир	M
Ғабиден	Габиден	M
Ғабидолла	Габидулла	M
Ғабит	Габит	M
Ғабитхан	Габитхан	M
Ғабсаттар	Габсаттар	M
Ғазиз	Газиз	M
Ғазиза	Газиза	F
Ғазиза	Газиза 	F
Ғазизбек	Газизбек	M
Ғазизжамал	Газизжамал	F
Ғазима	Газима	F
Ғазия	Газия  	F
Ғайни	Гайни	F
Ғайнигүл	Гайнигуль	F
Ғайнижамал	Гайнижамал	F
Ғайникамал	Гайникамал	F
Ғайса	Гайса	M
Ғайша	Гайша	F
Ғали	Гали	M
Ғалиакпар	Галиакпар	M
Ғалиасқар	Галиаскар	M
Ғалила	Галила	F
Ғалима	Галима	F
Галина	Галина	F
Ғалия	Галия	F
Ғалым	Галим	M
Ғалымбай	Галимбай	M
Ғалымбек	Галимбек	M
Ғалымжан	Галимжан	M
Гандира	Гандира	F
Ғани	Гани	M
Ғанибек	Ганибек	M
Ганна	Ганна	F
Ғаппар	Гаппар	M
Ғаппас	Гаппас	M
Ғарифа	Гарифа	F
Ғарифолла	Гарифулла	M
Ғатау	Гатау	M
Гауһар	Гаухар	F
Гаухар	Гаухар	F
Гаухария	Гаухария	F
Ғафар	Гафар	M
Ғафу	Гафу	M
Ғафура	Гафура	F
Гаяна	Гаяна	F
Ғибатолла	Гибатулла	M
Ғидаят	Гидаят	M
Ғизат	Гизат	M
Ғинаят	Гинаят	M
Гүлажар	Гульажар	F
Гүлай	Гульай	F
Гүлайна	Гульайна	F
Гүлайша	Гулайша	F
Гүлайым	Гульайым	F
Гүлара	Гульара	F
Гүлат	Гулат	F
Гүлбадан	Гульбадан	F
Гүлбазира	Гульбазира	F
Гүлбақша	Гульбакша	F
Гүлбанат	Гульбанат	F
Гүлбану	Гульбану	F
Гүлбара	Гульбара	F
Гүлбараш	Гульбараш	F
Гүлбарша	Гульбарша	F
Гүлбаршын	Гульбаршин	F
Гүлбахрам	Гульбахрам	F
Гүлбаян	Гульбаян	F
Гүлбибі	Гульбиби	F
Гүлболсын	Гульболсын	F
Гүлғайша	Гульгайша	F
Гүлдана	Гульдана	F
Гүлдара	Гульдара	F
Гүлдария	Гульдария	F
Гүлдархан	Гульдархан	F
Гүлейқан	Гулейхан	F
Гүләйім	Гульаим	F
Гүлжазира	Гульжазира	F
Гүлжайна	Гулжайна	F
Гүлжамал	Гульжамал	F
Гүлжамила	Гульжамила	F
Гүлжан	Гульжан	F
Гүлжанар	Гулжанар	F
Гүлжау	Гульжау	F
Гүлжаухар	Гульжаухар	F
Гүлжеңіс	Гульженис	F
Гүлжәмила	Гульжамила	F
Гүлжихан	Гульжихан	F
Гүлжия	Гульжия	F
Гүлжиян	Гульжиян	F
Гүлжу	Гульжу	F
Гүлзағида	Гульзагида	F
Гүлзағила	Гульзагила	F
Гүлзағира	Гульзагира	F
Гүлзада	Гульзада	F
Гүлзай	Гульзай	F
Гүлзара	Гульзара	F
Гүлзарифа	Гульзарифа	F
Гүлзария	Гульзария	F
Гүлзейнеп	Гульзейнеп	F
Гүлзина	Гульзина	F
Гүлзипа	Гульзипа	F
Гүлзира	Гульзира	F
Гүлиса	Гулиса	F
Гүлмара	Гульмара	F
Гүлмаржан	Гульмаржан	F
Гүлмария	Гульмария	F
Гүлмерей	Гульмерей	F
Гүлмира	Гульмира	F
Гүлназ	Гульназ	F
Гүлназат	Гулназат	F
Гүлнақиса	Гульнакиса	F
Гүлнар	Гульнар	F
Гүлнара	Гульнара	F
Гүлнафиса	Гульнафиса	F
Гүлнәзира	Гульназира	F
Гүлниса	Гульниса	F
Гүлнүр	Гульнур	F
Гүлнұра	Гульнура	F
Гүлпан	Гульпан	F
Гүлпара	Гульпара	F
Гүлпаш	Гульпаш	F
Гүлрауза	Гульрауза	F
Гүлсағыра	Гульсагира	F
Гүлсанат	Гульсанат	F
Гүлсара	Гульсара	F
Гүлсипат	Гульсипат	F
Гүлсім	Гульсим	F
Гүлсінай	Гульсинай	F
Гүлстан	Гульстан	F
Гүлфараз	Гульфараз	F
Гүлханым	Гульханым	F
Гүлшар	Гульшар	F
Гүлшара	Гульшара	F
Гүлшаруан	Гульшаруан	F
Гүлшат	Гульшат	F
Гүлшаш	Гульшаш	F
Гүлшекер	Гульшекер	F
Ғұбайдолла	Губайдулла	M
Ғұлам	Гулам	M
Ғұмар	Гумар	M
Ғұсман	Гусман	M
Ғұсманғали	Гусмангали	M
Ғылман	Гилман	M
Дабыл	Дабыл	M
Дабыр	Дабыр	M
Дабыс	Дабыс	M
Дағия	Дагия	F
Дадабай	Дадабай	M
Дадай	Дадай	M
Дайана	Дайана	F
Дайма	Дайма	F
Дайра	Дайра	F
Дайрабай	Дайрабай	M
Дайраш	Дайраш	M
Дайын	Дайын	M
Дайын	Даин	M
Дайыр	Даир	M
Дайырбек	Даирбек	M
Дайыржан	Даиржан	M
Дален	Дален	M
Далила	Далила	F
Дамай	Дамай	M
Дамина	Дамина	F
Дамир	Дамир	M
Дамира	Дамира	F
Дамыл	Дамыл	M
Дамыл	Дамил	M
Дана	Дана	F
Данагүл	Данагуль	F
Даназия	Даназия	F
Данай	Данай	M
Данайбек	Данайбек	M
Даналық	Даналык	M
Данара	Данара	F
Дандай	Дандай	M
Даниса	Даниса	F
Даниял	Даниял	M
Данияр	Данияр	M
Данышпан	Данышпан	M
Дара	Дара	F
Дара	Дара	M
Дарагүл	Дарагуль	F
Дарас	Дарас	M
Даржан	Даржан	M
Даржұман	Даржуман	M
Дариға	Дарига	F
Дарико	Дарико	F
Дария	Дария	F
Дарула	Дарула	F
Дархан	Дархан	M
Дарханбай	Дарханбай	M
Дарын	Дарын	M
Дастан	Дастан	M
Дастанбек	Дастанбек	M
Дауа	Дауа	F
Дауылбай	Даулбай	M
Дегдар	Дегдар	M
Демей	Демей	M
Демесін	Демесин	M
Деметан	Деметан	M
Демеу	Демеу	M
Демеш	Демеш	M
Демият	Демият	M
Дендар	Дендар	M
Денеш	Денеш	M
Денис	Денис	M
Дербай	Дербай	M
Дербісәлі	Дербисали	M
Дерлік	Дерлик	M
Дәлбек	Далбек	M
Дәлбек	Дальбек	M
Дәлелхан	Далелхан	M
Дәлила	Далила	F
Дәмбек	Дамбек	M
Дәмегүл	Дамегуль	F
Дәмежан	Дамежан	F
Дәмек	Дамек	M
Дәмелі	Дамели	F
Дәметай	Даметай	F
Дәмеш	Дамеш	F
Дәмиға	Дамига	F
Дәмина	Дамина	F
Дәмиша	Дамиша	F
Дәнегүл	Данегуль	F
Дәнекер	Данекер	F
Дәнен	Данен	M
Дәнеш	Данеш	F
Дәния	Дания	F
Дәрен	Дарен	M
Дәриға	Дарига	F
Дәрия	Дария	F
Дәрігүл	Даригуль	F
Дәріжан	Дарижан	F
Дәріш	Дариш	M
Дәркей	Даркей	M
Дәркенбай	Даркенбай	M
Дәрмен	Дармен	M
Дәубек	Даубек	M
Дәуен	Дауен	M
Дәуір	Даур	M
Дәуірбек	Дауирбек	M
Дәуірбек	Даурбек	M
Дәуіт	Даут	M
Дәуітәлі	Даутали	M
Дәукебай	Даукебай	M
Дәулен	Даулен	M
Дәуленхан	Дауленхан	M
Дәулет	Даулет	M
Дәулетбай	Даулетбай	M
Дәулетбақ	Даулетбак	M
Дәулетбек	Даулетбек	M
Дәулетғазы	Даулетгази	M
Дәулетғали	Даулетгали	M
Дәулетәлі	Даулетали	M
Дәулетияр	Даулетияр	M
Дәулеткелді	Даулеткельды	M
Дәулеткерей	Даулеткерей	M
Дәулетқали	Даулеткали	M
Дәулетхан	Даулетхан	M
Дәулетше	Даулетше	M
Дәурен	Даурен	M
Дәуренбек	Дауренбек	M
Дәутай	Даутай	M
Диана	Диана	F
Диас	Диас	M
Дибай	Дибай	M
Дидара	Дидара	F
Дидарбек	Дидарбек	M
Дииара	Динара	F
Диқан	Дихан	M
Диқанбай	Диханбай	M
Дила	Дила	F
Дильназ	Дильназ	F
Дина	Дина	F
Динара	Динара	F
Дияр	Дияр	M
Дияра	Дияра	F
Диярбек	Диярбек	M
Ділара	Дилара	F
Ділбар	Дильбар	F
Ділбара	Дильбара	F
Ділда	Дильда	F
Ділдабек	Дильдабек	M
Ділдаш	Дильдаш	F
Дінасыл	Динасыл	M
Дінмұхамбет	Динмухамбет	M
Додан	Додан	M
Дойман	Дойман	M
Долай	Долай	M
Долан	Долан	M
Доллорес	Доллорес	F
Донай	Донай	M
Донбай	Донбай	M
Донбек	Донбек	M
Донкей	Донкей	M
Дос	Дос	M
Досай	Досай	M
Досайбек	Досайбек	M
Досақ	Досак	M
Досан	Досан	M
Досбай	Досбай	M
Досберген	Досберген	M
Досәлі	Досали	M
Досжан	Досжан	M
Доскей	Доскей	M
Доскелді	Доскельды	M
Досқара	Доскара	M
Досмет	Досмет	M
Досмұқамбет	Досмухамбет	M
Досмұқан	Досмукан	M
Доспан	Доспан	M
Достақ	Достак	M
Достан	Достан	M
Достияр	Достияр	M
Досым	Досым	M
Досымбек	Досымбек	M
Досымжан	Досымжан	M
Дотан	Дотан	M
Дөнентай	Донентай	M
Дуан	Дуан	F
Дуанбай	Дуанбай	M
Дубай	Дубай	M
Дудар	Дудар	M
Дулат	Дулат	M
Дулатхан	Дулатхан	M
Думан	Думан	M
Думангүл	Думангуль	F
Дутбай	Дутбай	M
Дүйсебай	Дуйсебай	M
Дүйсек	Дуйсек	M
Дүйсекей	Дуйсекей	M
Дүйсен	Дуйсен	M
Дүйсенбай	Дуйсенбай	M
Дүйсенбі	Дуйсенби	M
Дүйсетай	Дуйсетай	M
Дүкенбай	Дукенбай	M
Дүнгенбай	Дунганбай	M
Дүниезада	Дуниезада	F
Дүния	Дуния	F
Дүрбай	Дурбай	M
Дүрбек	Дурбек	M
Дүрдана	Дурдана	F
Дүрия	Дурия	F
Дыбыс	Дыбыс	F
Егей	Егей	M
Егемберді	Егемберды	M
Егеубай	Егеубай	M
Егібай	Егибай	M
Егізбай	Егизбай	M
Егізбек	Егизбек	M
Егізек	Егизек	M
Едіге	Едиге	M
Едіген	Едиген	M
Еділ	Едиль	M
Еділбай	Едильбай	M
Еламан	Еламан	M
Елбар	Елбар	M
Елбас	Елбас	M
Елбастар	Елбастар	M
Елбек	Елбек	M
Елгүл	Елгуль	F
Елдана	Елдана	F
Елдар	Елдар	M
Елдес	Елдес	M
Елдос	Елдос	M
Елебай	Елебай	M
Елебек	Елебек	M
Елен	Елен	M
Елена	Елена	F
Елентай	Елентай	F
Елес	Елес	M
Елеу	Елеу	M
Елеубай	Елеубай	M
Елеуіс	Елеус	M
Елеукен	Елеукен	M
Елеш	Елеш	M
Елжан	Елжан	M
Елжар	Елжар	M
Елжас	Елжас	M
Елжас	Ельжас	M
Елжасар	Елжасар	M
Елжасар	Ельжасар	M
Елібай	Елибай	M
Елібек	Елибек	M
Елқам	Елкам	M
Елқон	Елкон	M
Елқонды	Елконды	M
Елман	Елман	M
Елмұқамбек	Елмухамбек	M
Елмұрат	Елмурат	M
Елмырза	Елмурза	M
Елназ	Елназ	M
Елназар	Елназар	M
Елнар	Елнар	M
Елнұр	Елнур	M
Елсүйер	Елсуйер	M
Елтан	Елтан	M
Елтоқ	Елток	M
Елубай	Елубай	M
Елшібай	Елшибай	M
Емелжан	Емельжан	M
Еменалы	Еменалы	M
Еміл	Емиль	M
Енсебек	Енсебек	M
Енсеген	Енсеген	M
Енсеп	Енсеп	M
Енсер	Енсер	M
Еңлік	Енлик	F
Еңсебек	Енсебек	M
Ералы	Ералы	M
Ерасыл	Ерасыл	M
Ербай	Ербай	M
Ербақ	Ербак	M
Ербала	Ербала	M
Ербатыр	Ербатыр	M
Ербек	Ербек	M
Ербел	Ербель	M
Ербол	Ербол	M
Ерболат	Ерболат	M
Ерболсын	Ерболсын	M
Ербосын	Ербосын	M
Ербота	Ербота	M
Ерғазы	Ергазы	M
Ерғалау	Ергалау	M
Ерғали	Ергали	M
Ерғара	Ергара	M
Ергеш	Ергеш	M
Ерғожа	Ергожа	M
Ердана	Ердана	M
Ердар	Ердар	M
Ерден	Ерден	M
Ерденай	Ерденай	M
Ерденбай	Ерденбай	M
Ерденбек	Ерденбек	M
Ердеш	Ердеш	M
Ердәулет	Ердаулет	M
Ережеп	Ережеп	M
Ерен	Ерен	M
Ержан	Ержан	M
Ержекей	Ержекей	M
Ержігіт	Ержигит	M
Ержұман	Ержуман	M
Ерзада	Ерзада	F
Ерзиба	Ерзиба	F
Ерзия	Ерзия	F
Ерзияш	Ерзияш	F
Ерік	Ерик	M
Ерікті	Ерикти	M
Ерімбек	Еримбек	M
Ерімбет	Еримбет	M
Ерке	Ерке	F
Еркебай	Еркебай	M
Еркебала	Еркебала	F
Еркеболат	Еркеболат	M
Еркебұлан	Еркебулан	M
Еркеғали	Еркегали	M
Еркегүл	Еркегуль	F
Еркежан	Еркежан	F
Еркетай	Еркетай	M
Еркеш	Еркеш	M
Еркін	Еркин	M
Еркінбай	Еркинбай	M
Еркінбек	Еркинбек	M
Еркінғали	Еркингали	M
Еркінкүл	Еркинкуль	F
Еркінтай	Еркинтай	M
Еркіш	Еркиш	F
Ерқуат	Еркуат	M
Ерлан	Ерлан	M
Ерлен	Ерлен	M
Ерлепес	Ерлепес	M
Ерлес	Ерлес	M
Ерлік	Ерлик	M
Ермағамбет	Ермагамбет	M
Ерман	Ерман	M
Ермат	Ермат	M
Ермек	Ермек	M
Ермекәлі	Ермекали	M
Ермекқали	Ермеккали	M
Ермұқамбет	Ермухамбет	M
Ермұрат	Ермурат	M
Ерназар	Ерназар	M
Ернар	Ернар	M
Ернұр	Ернур	M
Ерсаға	Ерсага	M
Ерсайын	Ерсайын	M
Ерсайын	Ерсаин	M
Ерсары	Ерсары	M
Ерсеиіт	Ерсеит	M
Ерсәли	Ерсали	M
Ерсұлтан	Ерсултан	M
Ертай	Ертай	M
Ертілес	Ертилес	M
Ертілес	Ертлес	M
Ертілеу	Ертлеу	M
Ертіс	Ертис	M
Ертуған	Ертуган	M
Ерубай	Ерубай	M
Ершу	Ершу	M
Ес	Ес	M
Есбай	Есбай	M
Есбатыр	Есбатыр	M
Есберген	Есберген	M
Есберді	Есберды	M
Есбол	Есбол	M
Есболат	Есболат	M
Есдәуір	Есдаур	M
Есдәулет	Есдаулет	M
Есей	Есей	M
Есейжан	Есейжан	M
Есен	Есен	M
Есенай	Есенай	M
Есеналы	Есенали	M
Есенаман	Есенаман	M
Есенбай	Есенбай	M
Есенбақы	Есенбаки	M
Есенберді	Есенберди	M
Есенғали	Есенгали	M
Есенғұл	Есенгул	M
Есендік	Есендык	M
Есенәлі	Есенали	M
Есенжан	Есенжан	M
Есенжол	Есенжол	M
Есенқан	Есенхан	M
Есенмұрат	Есенмурат	M
Есенсейіт	Есенсеит	M
Есентай	Есентай	M
Есентемір	Есентемир	M
Есет	Есет	M
Есәлі	Есали	M
Есжан	Есжан	M
Есіл	Есил	M
Есіл	Есиль	M
Есілбай	Есилбай	M
Есілбай	Есильбай	M
Есім	Есим	M
Есімбек	Есимбек	M
Есімжан	Есимжан	M
Есімхан	Есимхан	M
Есірке	Есирке	M
Есіркеген	Есиркеген	M
Есіркеп	Есиркеп	M
Ескали	Ескали	M
Ескен	Ескен	M
Ескендір	Ескендир	M
Есқайыр	Ескаир	M
Есқожа	Есхожа	M
Есмағамбет	Есмагамбет	M
Есман	Есман	M
Есмұқан	Есмукан	M
Есмұрат	Есмурат	M
Есназар	Есназар	M
Еспембет	Еспембет	M
Естемес	Естемес	M
Естен	Естен	M
Естібай	Естибай	M
Ешаман	Ешаман	M
Ешбай	Ешбай	M
Ешкен	Ешкен	M
Ешмухамбет	Ешмухамбет	M
Ешмұрат	Ешмурат	M
Ештай	Ештай	M
Әбдеш	Абдеш	M
Әбді	Абди	M
Әбдібай	Абдибай	M
Әбдіғазы	Абдигазы	M
Әбдіғали	Абдигали	M
Әбдіжаппар	Абдижаппар	M
Әбдіжәміл	Абдижамил	M
Әбдік	Абдик	M
Әбдікадыр	Абдикадыр	M
Әбдікен	Абдикен	M
Әбдікәрім	Абдикарим	M
Әбділда	Абдильда	M
Әбдіманап	Абдиманап	M
Әбдір	Абдир	M
Әбдіразақ	Абдразак	M
Әбдірайым	Абдрайм	M
Әбдірақ	Абдрах	M
Әбдірахман	Абдрахман	M
Әбдірашит	Абдрашит	M
Әбдірей	Абдрей	M
Әбдірәлі	Абдрали	M
Әбдірәш	Абдраш	M
Әбдісаттар	Абдисаттар	M
Әбдіхалық	Абдихалык	M
Әбдуәли	Абдуали	M
Әбебай	Абебай	M
Әбен	Абен	M
Әбет	Абет	M
Әбеу	Абеу	M
Әбжан	Абжан	M
Әбжәми	Абжами	M
Әбиба	Абиба	F
Әбиболла	Абибулла	M
Әбира	Абира	F
Әбікан	Абихан	M
Әбікен	Абикен	M
Әбіл	Абиль	M
Әбілбек	Абильбек	M
Әбілғазиз	Абильгазиз	M
Әбілғазы	Абильгазы	M
Әбілжан	Абильжан	M
Әбілқай	Абилькай	M
Әбілқайыр	Абильхаир	M
Әбілқан	Абилкан	M
Әбілқан	Абильхан	M
Әбілқасым	Абилькасым	M
Әбіш	Абиш	M
Әбсалам	Абсалам	M
Әбсейіт	Абсеит	M
Әбсәлім	Абсалим	M
Әбсәмат	Абсамат	M
Әбу	Абу	M
Әбубәкір	Абубакир	M
Әбуғали	Абугали	M
Әбузар	Абузар	M
Әбунасыр	Абунасир	M
Әбусадық	Абусадык	M
Әбусейіт	Абусеит	M
Әбухамит	Абухамит	M
Әбухан	Абухан	M
Әделия	Аделия	F
Әдемі	Адеми	F
Әди	Ади	M
Әдиба	Адиба	F
Әдида	Адида	F
Әдиет	Адиет	M
Әдила	Адила	F
Әдина	Адина	F
Әдипа	Адипа	F
Әдиса	Адиса	F
Әдия	Адия	F
Әдібай	Адибай	M
Әдікан	Адихан	M
Әділ	Адиль	M
Әділбек	Адильбек	M
Әділғазы	Адильгазы	M
Әділжан	Адильжан	M
Әділия	Адилия	F
Әділхан	Адильхан	M
Әділші	Адилши	M
Әдірбек	Адирбек	M
Әжі	Ажи	M
Әжібай	Ажибай	M
Әжібек	Ажибек	M
Әжіғали	Ажигали	M
Әжімұрат	Ажимурат	M
Әжкей	Ажкей	M
Әзербай	Азербай	M
Әзербайжан	Азербайжан	M
Әзи	Әзи	M
Әзиға	Азига	F
Әзиза	Азиза	F
Әзила	Азила	F
Әзима	Азима	F
Әзина	Азина	F
Әзипа	Азипа	F
Әзияша	Азияша	F
Әзіз	Азиз	M
Әзізхан	Азизхан	M
Әзілқан	Азильхан	M
Әзім	Азим	M
Әзімбай	Азимбай	M
Әзімжан	Азимжан	M
Әзімхан	Азимхан	M
Әзпза	Азиза	F
Әиімбет	Аймбет	M
Әйгерім	Айгерим	F
Әйміш	Аймиш	M
Әйнек	Айнек	F
Әйтеқ	Айтек	M
Әйтен	Айтен	M
Әкіжан	Акижан	M
Әкім	Аким	M
Әкімбай	Акимбай	M
Әкімбек	Акимбек	M
Әкімғожа	Акимгожа	M
Әкімжан	Акимжан	M
Әкімхан	Акимхан	M
Әкірам	Акрам	M
Әкіш	Акиш	M
Әкпар	Акпар	M
Әлбатыр	Альбатыр	M
Әлғазы	Альгазы	M
Әлғожа	Альгожа	M
Әлемгүл	Алемгуль	F
Әлемкүл	Алемкуль	F
Әлен	Ален	M
Әлес	Алес	M
Әлжан	Альжан	M
Әлжапар	Альжапар	M
Әли	Али	M
Әлиайдар	Алиайдар	M
Әлиакпар	Алиакпар	M
Әлиасқар	Алиаскар	M
Әлиға	Алига	F
Әлиза	Ализа	F
Әлиқан	Алихан	M
Әлила	Алила	F
Әлима	Алима	F
Әлипа	Алипа	F
Әлиса	Алиса	F
Әлиша	Алиша	F
Әлия	Алия	F
Әлібай	Алибай	M
Әлібек	Алибек	M
Әліби	Алиби	M
Әлім	Алим	M
Әлімбай	Алимбай	M
Әлімбек	Алимбек	M
Әлімбет	Алимбет	M
Әлімғазы	Алимгазы	M
Әлімғожа	Алимгожа	M
Әлімжан	Алимжан	M
Әлімқұл	Алимкул	M
Әлімхан	Алимхан	M
Әліпбай	Алипбай	M
Әліпбек	Алипбек	M
Әліш	Алиш	M
Әлішер	Алишер	M
Әлкей	Алькей	M
Әлкен	Алькен	M
Әлқадыр	Алькадыр	M
Әлқуат	Алькуат	M
Әлмақан	Альмакан	M
Әлмұқамбет	Альмухамбет	M
Әлмұрат	Альмурат	M
Әлнұр	Альнур	M
Әлсейіт	Альсеит	M
Әлтай	Альтай	M
Әлуаза	Алуаза	F
Әлфия	Альфия	F
Әлхан	Альхан	F
Әмбе	Амбе	M
Әмеди	Амеди	M
Әмен	Амен	M
Әмзе	Амзе	M
Әмила	Амила	F
Әмин	Амин	M
Әмина	Амина	F
Әмира	Амира	F
Әмір	Амир	M
Әміралы	Амиралы	M
Әмірбай	Амирбай	M
Әмірбек	Амирбек	M
Әмірғазы	Амиргази	M
Әмірғали	Амиргали	M
Әміре	Амре	M
Әмірен	Амрен	M
Әміреш	Амреш	M
Әміржан	Амиржан	M
Әмірлан	Амирлан	M
Әмірхан	Амирхан	M
Әнапия	Анапия	F
Әнел	Анель	F
Әнес	Анес	M
Әниза	Аниза	F
Әнипа	Анипа	F
Әниса	Аниса	F
Әнтай	Антай	M
Әнуар	Ануар	M
Әнуарбек	Ануарбек	M
Әнуархан	Ануархан	M
Әпек	Апек	M
Әпес	Апес	M
Әпиза	Апиза	F
Әрекен	Арекен	M
Әрипа	Арипа	F
Әрия	Ария	F
Әріп	Арип	M
Әріпбай	Арипбай	M
Әруаш	Аруаш	M
Әсел	Асель	F
Әсем	Асем	F
Әсембике	Асембике	F
Әсемгүл	Асемгуль	F
Әсемкан	Асемхан	F
Әсемхан	Асемхан	F
Әсен	Асен	F
Әсен	Асен	M
Әсет	Асет	M
Әси	Аси	M
Әсима	Асима	F
Әсипа	Асипа	F
Әсіп	Асип	M
Әскен	Аскен	M
Әскер	Аскер	M
Әспет	Аспет	M
Әтей	Атей	M
Әтек	Атек	M
Әтен	Атен	M
Әтина	Атина	F
Әтір	Атир	F
Әубәкір	Аубакир	M
Әуез	Ауэз	M
Әуезхан	Ауэзхан	M
Әуел	Ауель	M
Әуелбай	Ауельбай	M
Әуелбек	Ауельбек	M
Әуесбай	Ауесбай	M
Әуесхан	Ауесхан	M
Әужа	Аужа	F
Әукебай	Аукебай	M
Әукен	Аукен	M
Әшедан	Ашедан	M
Әшекей	Ашекей	M
Әшет	Ашет	M
Әшім	Ашим	M
Әшімбай	Ашимбай	M
Әшімхан	Ашимхан	M
Әшір	Ашир	M
Әшірбай	Аширбай	M
Әшірбек	Аширбек	M
Әшірғали	Аширгали	M
Әшірәлі	Аширали	M
Әшірмұрат	Аширмурат	M
Әшірхан	Аширхан	M
Әшкей	Ашкей	M
Әшкен	Ашкен	M
Жабай	Жабай	M
Жабақ	Жабак	M
Жабал	Жабал	M
Жабан	Жабан	M
Жабас	Жабас	M
Жабатай	Жабатай	M
Жаби	Жаби	M
Жабырбай	Жабырбай	M
Жаған	Жаган	M
Жағатай	Жагатай	M
Жағыпар	Жагипар	M
Жадай	Жадай	M
Жадан	Жадан	M
Жадыра	Жадыра	F
Жадыра	Жадыра	M
Жазира	Жазира	F
Жазкен	Жазкен	M
Жазыбай	Жазыбай	M
Жазық	Жазык	M
Жазылбек	Жазылбек	M
Жайдар	Жайдар	M
Жайдарбек	Жайдарбек	M
Жайкен	Жайкен	M
Жайқақ	Жайкак	M
Жайлау	Жайлау	M
Жайлаубай	Жайлаубай	M
Жайлыбай	Жайлыбай	M
Жайна	Жайна	F
Жайнақ	Жайнак	M
Жайнақан	Жайнакан	F
Жайсақ	Жайсак	M
Жайсан	Жайсан	M
Жайсанбай	Жайсанбай	M
Жайсанбек	Жайсанбек	M
Жайтабар	Жайтабар	M
Жайық	Жайык	M
Жайық	Жаик	M
Жаксымұрат	Жаксымурат	M
Жакын	Жакин	M
Жакынбек	Жакинбек	M
Жакып	Жакип	M
Жақа	Жака	M
Жақай	Жакай	M
Жақан	Жахан	M
Жақат	Жакат	M
Жақатай	Жакатай	M
Жақау	Жакау	M
Жақаш	Жакаш	M
Жақи	Жаки	M
Жақия	Жахия	M
Жақия	Жакия	M
Жақсыбай	Жаксыбай	M
Жақсығали	Жаксыгали	M
Жақсығұл	Жаксыгул	M
Жақсылық	Жаксылык	M
Жақыпбай	Жакипбай	M
Жақыпбек	Жакипбек	M
Жалбыр	Жалбыр	M
Жалғас	Жалгас	M
Жалғасбай	Жалгасбай	M
Жалғасбек	Жалгасбек	M
Жалел	Жалел	M
Жалмұқан	Жалмухан	M
Жалтыр	Жалтыр	M
Жалын	Жалын	M
Жалынша	Жалынша	F
Жамал	Жамал	F
Жамалай	Жамалай	F
Жамалбек	Жамалбек	M
Жамали	Жамали	F
Жамалия	Жамалия	F
Жамалхан	Жамалхан	F
Жаманғара	Жамангара	M
Жамбай	Жамбай	M
Жамбы	Жамбы	F
Жамбыл	Жамбыл	M
Жамиға	Жамига	F
Жамил	Жамиль	M
Жамықай	Жамыкай	M
Жамыхан	Жамыхан	M
Жанабай	Жанабай	M
Жанабек	Жанабек	M
Жаназия	Жаназия	F
Жанай	Жанай	M
Жанайдар	Жанайдар	M
Жанақ	Жанак	M
Жаналы	Жанали	M
Жанан	Жанан	F
Жанана	Жанана	F
Жанар	Жанар	F
Жанар	Жанар	M
Жанаргүл	Жанаргуль	F
Жанарыс	Жанарыс	M
Жанарыстан	Жанарыстан	M
Жанас	Жанас	M
Жанат	Жанат	F
Жанат	Жанат	M
Жанатай	Жанатай	M
Жанатбек	Жанатбек	M
Жанаткүл	Жанаткуль	F
Жанахмет	Жанахмет	M
Жанбай	Жанбай	M
Жанбақи	Жанбаки	M
Жанбек	Жанбек	M
Жанбике	Жанбике	F
Жанболат	Жанболат	M
Жанбосын	Жанбосын	M
Жанбота	Жанбота	M
Жанбұра	Жанбура	M
Жанғазы	Жангази	M
Жанғали	Жангали	M
Жангелді	Жангельды	M
Жанғозы	Жангозы	M
Жанғойлық	Жангойлык	M
Жандабол	Жандабол	M
Жандай	Жандай	M
Жандар	Жандар	M
Жандарбек	Жандарбек	M
Жандерке	Жандерке	M
Жандос	Жандос	M
Жандыбай	Жандыбай	M
Жанерке	Жанерке	F
Жанеркін	Жанеркин	M
Жанетта	Жанетта	F
Жанәбіл	Жанабиль	M
Жанжа	Жанжа	M
Жанжігіт	Жанжигит	M
Жанзила	Жанзила	F
Жанзия	Жанзия	F
Жани	Жани	M
Жаниға	Жанига	F
Жанипа	Жанипа	F
Жанира	Жанира	F
Жанифа	Жанифа	F
Жания	Жания	F
Жанке	Жанке	M
Жанкүміс	Жанкумис	F
Жанқаби	Жанкаби	M
Жанқуат	Жанкуат	M
Жанмұрат	Жанмурат	M
Жанна	Жанна	F
Жанназар	Жанназар	M
Жаннат	Жаннат	F
Жаннияз	Жаннияз	M
Жанораз	Жанораз	M
Жанпейіс	Жанпеис	M
Жансал	Жансал	M
Жансары	Жансары	M
Жансая	Жансая	F
Жансая	Жансая	M
Жансүгір	Жансугур	M
Жансүйер	Жансуйер	M
Жансұлтан	Жансултан	M
Жансұлу	Жансулу	F
Жансұлу	Жансулу	M
Жантай	Жантай	M
Жантаймас	Жантаймас	M
Жантас	Жантас	M
Жантау	Жантау	M
Жантеке	Жантеке	M
Жантемір	Жантемир	M
Жантілеу	Жантлеу	M
Жантірек	Жантрек	M
Жантөре	Жантуре	M
Жантөре	Жанторе	M
Жантуар	Жантуар	M
Жантуған	Жантуган	M
Жантұр	Жантур	M
Жантұрсын	Жантурсын	M
Жанұзақ	Жанузак	M
Жанша	Жанша	F
Жанша	Жанша	M
Жаншуак	Жаншуак	M
Жаңабай	Жанабай	M
Жапақ	Жапак	M
Жапан	Жапан	M
Жапар	Жапар	M
Жаппар	Жаппар	M
Жаппас	Жаппас	M
Жаппасбай	Жаппасбай	M
Жарас	Жарас	M
Жарбас	Жарбас	M
Жарбол	Жарбол	M
Жарбосын	Жарбосын	M
Жарқын	Жаркин	M
Жарқынбеіс	Жаркинбек	M
Жармақ	Жармак	M
Жартыбай	Жартыбай	M
Жарыкетер	Жаркетер	M
Жарық	Жарык	M
Жарықбай	Жарикбай	M
Жарылғап	Жарылгап	M
Жарылқасын	Жарылкасын	M
Жарымбет	Жарымбет	M
Жасақбай	Жасакбай	M
Жасамыс	Жасамыс	M
Жасбілім	Жасбилим	M
Жаскелең	Жаскелен	M
Жаскен	Жаскен	M
Жасқайрат	Жаскайрат	M
Жасталап	Жасталап	M
Жасура	Жасура	F
Жасұзақ	Жасузак	M
Жасұлан	Жасулан	M
Жасыбай	Жасыбай	M
Жатай	Жатай	M
Жауар	Ауар	M
Жаугер	Жаугер	M
Жауһар	Жаухар	F
Жауһария	Жаухария	F
Жаыдәулет	Жандаулет	M
Жекен	Жекен	M
Жексен	Жексен	M
Жексенбай	Жексенбай	M
Жемісай	Жемисай	F
Жемісбек	Жемисбек	M
Жемісгүл	Жемисгуль	F
Жеңіс	Женис	M
Жеңісгүл	Женисгуль	F
Жеңісқан	Женисхан	M
Жетекеш	Жетекеш	M
Жетен	Жетен	M
Жетес	Жетес	M
Жетібай	Жетибай	M
Жетіген	Жетиген	M
Жетік	Жетик	M
Жетістік	Жетистик	M
Жеткерген	Жеткерген	M
Жеткіз	Жеткиз	M
Жеткіншек	Жеткиншек	M
Жәдігер	Жадигер	M
Жәкен	Жакен	M
Жәкет	Жакет	M
Жәлел	Жалел	M
Жәлила	Жалила	F
Жәмен	Жамен	M
Жәмәди	Жамади	M
Жәми	Жами	M
Жәмила	Жамила	F
Жәміш	Жамиш	M
Жәмшит	Жамшит	M
Жәнібек	Жанибек	M
Жәнке	Жанке	M
Жәңгір	Жангир	M
Жәрдем	Жардем	M
Жәркеш	Жаркеш	M
Жәутік	Жаутык	M
Жидебай	Жидебай	M
Жиенбай	Жиенбай	M
Жиенбек	Жиенбек	M
Жиенғали	Жиенгали	M
Жиһанша	Жиханша	M
Жиренше	Жиренше	M
Жиынысбай	Жиынысбай	M
Жияс	Жияс	M
Жібек	Жибек	F
Жігер	Жигер	M
Жолай	Жолай	M
Жолан	Жолан	M
Жолбай	Жолбай	M
Жолдас	Жолдас	M
Жолдасбай	Жолдасбай	M
Жолдасбек	Жолдасбек	M
Жолдасқан	Жолдаскан	M
Жолдасқан	Жолдасхан	M
Жолды	Жолды	M
Жолдыбай	Жолдыбай	M
Жолмұқамет	Жолмухамет	M
Жолмұрат	Жолмурат	M
Жолмырза	Жолмурза	M
Жолсейіт	Жолсеит	M
Жолтай	Жолтай	M
Жолшыбек	Жолшибек	M
Жолымбет	Жолымбет	M
Жомарт	Жомарт	M
Жомартбай	Жомартбай	M
Жомартбек	Жомартбек	M
Жора	Жора	M
Жорабай	Жорабай	M
Жорабек	Жорабек	M
Жордан	Жордан	M
Жосанбай	Жосанбай	M
Жотабай	Жотабай	M
Жуандық	Жуандык	M
Жуаныш	Жуаныш	M
Жуанышбай	Жуанышбай	M
Жусанбай	Жусанбай	M
Жүгірәлі	Жуграли	M
Жүзай	Жузай	M
Жүзбай	Жузбай	M
Жүзия	Жузия	F
Жүніс	Жунус	M
Жүніс	Жунис	M
Жүнісбай	Жунусбай	M
Жүнісбай	Жунисбай	M
Жүрген	Журген	M
Жүрес	Журес	M
Жүрсін	Журсин	M
Жүрсін	Журсун	M
Жүсібәлі	Жусибали	M
Жүсіп	Жусуп	M
Жүсіп	Жусип	M
Жүсіпбек	Жусипбек	M
Жүсіпқали	Жусипкали	M
Жұбайда	Жубайда	F
Жұбан	Жубан	M
Жұбанияз	Жубанияз	M
Жұбаныш	Жубаныш	M
Жұзбай	Жузбай	M
Жұлдыз	Жулдыз	F
Жұлдызай	Жулдызай	F
Жұма	Жума	M
Жұмабай	Жумабай	M
Жұмабек	Жумабек	M
Жұмабике	Жумабике	F
Жұмағазы	Жумагази	M
Жұмағали	Жумагали	M
Жұмагелді	Жумагельды	M
Жұмагүл	Жумагуль	F
Жұмағұл	Жумагул	M
Жұмағыз	Жумагыз	F
Жұмадила	Жумадила	F
Жұмазия	Жумазия	F
Жұмамұрат	Жумамурат	M
Жұман	Жуман	M
Жұманазар	Жуманазар	M
Жұманбай	Жуманбай	M
Жұманияз	Жуманияз	M
Жұмат	Жумат	M
Жұматай	Жуматай	M
Жұмахан	Жумахан	M
Жұмахмет	Жумахмет	M
Жұмаш	Жумаш	F
Жұмаш	Жумаш	M
Жұмәділ	Жумадиль	M
Жұмәли	Жумали	M
Жұмыр	Жумыр	M
Жұпар	Жупар	F
Жұртбай	Журтбай	M
Жұртыбай	Журтыбай	M
Жылқышы	Жылкиши	M
Жырғал	Жиргал	M
Забила	Забила	F
Зағида	Загида	F
Зағила	Загила	F
Зағипа	Загипа	F
Зағира	Загира	F
Зағиша	Загиша	F
Заит	Заит	M
Зайда	Зайда	F
Зайна	Зайна	F
Зайра	Зайра	F
Зайса	Зайса	F
Зайтуна	Зайтуна	F
Зайыр	Заир	M
Зайырбек	Заирбек	M
Закария	Закария	M
Закарьян	Закарьян	M
Закина	Закина	F
Закира	Закира	F
Закония	Закония	F
Зақан	Закан	M
Зақаш	Закаш	M
Зақира	Закира	F
Заман	Заман	M
Заманбек	Заманбек	M
Замания	Замания	F
Замилия	Замилия	F
Замир	Замир	M
Замира	Замира	F
Заңғар	Зангар	M
Зара	Зара	F
Зарема	Зарема	F
Зариға	Зарига	F
Зарина	Зарина	F
Зарипа	Зарипа	F
Зарлық	Зарлык	F
Заря	Заря	F
Зауза	Зауза	F
Зейне	Зейне	F
Зейнегүл	Зейнегуль	F
Зейнел	Зейнель	M
Зейнеп	Зейпеп	F
Зейнет	Зейнет	M
Зейнехан	Зейнехан	F
Зейнеш	Зейнеш	F
Зейнолла	Зейнулла	M
Зейнур	Зейнур	M
Зейтік	Зейтик	M
Зекен	Зекен	M
Земфира	Земфира	F
Зергербек	Зергербек	M
Зергүл	Зергуль	F
Зерде	Зерде	F
Зере	Зере	F
Зәби	Заби	M
Зәбира	Забира	F
Зәйтүна	Зайтуна	F
Зәки	Заки	M
Зәкия	Закия	F
Зәкір	Закир	M
Зәкірбай	Закирбай	M
Зәкүмбай	Закумбай	M
Зәмзамия	Замзамия	F
Зәмзегүл	Замзегуль	F
Зәмзә	Замза	F
Зәмзәгүл	Замзагуль	F
Зәмзәмия	Замзамия	F
Зәмзия	Замзия	F
Зәрипа	Зарипа	F
Зәриша	Зариша	F
Зәріпқан	Зарипхан	M
Зәуір	Заур	M
Зәуірбай	Заурбай	M
Зәуре	Зауре	F
Зәуреш	Зауреш	F
Зиба	Зиба	F
Зибагүл	Зибагуль	F
Зибажан	Зибажан	F
Зила	Зила	F
Зиман	Зиман	M
Зина	Зина	F
Зинаида	Зинаида	F
Зинара	Зинара	F
Зинат	Зинат	F
Зинира	Зинира	F
Зиния	Зиния	F
Зира	Зира	F
Зия	Зия	F
Зиягүл	Зиягуль	F
Зияда	Зияда	F
Зиялы	Зиялы	F
Зият	Зият	M
Зиятбек	Зиятбек	M
Зияхан	Зияхан	F
Зияш	Зияш	F
Зікібай	Зикибай	M
Зікірия	Зикрия	M
Злиман	Злиман	F
Зоре	Зоре	F
Зоя	Зоя	F
Зубайда	Зубайда	F
Зупарзат	Зупарзат	F
Зура	Зура	F
Зураш	Зураш	F
Зухра	Зухра	F
Зүбайда	Зубайда	F
Зүбайра	Зубайра	F
Зүбәйза	Зубайза	F
Зүбәйла	Зубайла	F
Зүлипа	Зулипа	F
Зүлия	Зулия	F
Зүлфия	Зульфия	F
Зүмрат	Зумрат	F
Зұлкайыр	Зулкаир	M
Зұлқаш	Зулкаш	M
Зұлқия	Зульхия	F
Зұлпықар	Зульфукар	M
Зұлфия	Зульфия	F
Зықай	Зыкай	M
Зылиқа	Зылиха	F
Зылиқа	Злиха	F
Иба	Иба	F
Ибагүл	Ибагуль	F
Ибажан	Ибажан	F
Ибазар	Ибазар	M
Ибалы	Ибалы	F
Ибат	Ибат	M
Ибатай	Ибатай	M
Ибатжан	Ибатжан	M
Ибрагим	Ибрагим	M
Иген	Иген	M
Игенбай	Игенбай	M
Игідәулет	Игидаулет	M
Игілік	Игилик	M
Игілік	Иглик	M
Игісін	Игисин	M
Идеят	Идеят	M
Иембай	Иембай	M
Изатима	Изатима	F
Изетхан	Изетхан	F
Икрама	Икрама	F
Икраш	Икраш	M
Илаш	Илаш	F
Илмар	Илмар	M
Имақ	Имак	M
Иманас	Иманас	M
Иманбай	Иманбай	M
Иманбек	Иманбек	M
Иманғазы	Имангази	M
Иманғали	Имангали	M
Иманәлі	Иманали	M
Иманжүсіп	Иманжусип	M
Иманқұл	Иманкул	M
Имантай	Имантай	M
Имара	Имара	F
Имат	Имат	M
Имаш	Имаш	M
Имер	Имер	M
Инаят	Инаят	M
Инга	Инга	F
Индира	Индира	F
Инесса	Инесса	F
Ира	Ира	F
Ирада	Ирада	F
Ирайда	Ираида	F
Ирина	Ирина	F
Ирма	Ирма	F
Иса	Иса	M
Исабай	Исабай	M
Исабек	Исабек	M
Исағали	Исагали	M
Исаділ	Исадиль	M
Исак	Исак	M
Исакай	Исакай	M
Исакан	Исахан	M
Исамұқамбет	Исамухамбет	M
Исан	Исан	M
Исатай	Исатай	M
Исахмет	Исахмет	M
Исламхан	Исламхан	M
Иұрсұлу	Нурсулу	F
Ишан	Ишан	M
Ишанбай	Ишанбай	M
Ишар	Ишар	M
Ишат	Ишат	M
Ібіжан	Ибижан	M
Ібікен	Ибикен	M
Ібітан	Ибитан	M
Ібіш	Ибиш	M
Ібни	Ибни	M
Ізбайша	Избайша	F
Ізбас	Избас	M
Ізбасар	Избасар	M
Ізгілік	Изглик	M
Ізтай	Изтай	M
Ілебай	Илебай	M
Ілебай	Лебай	M
Ілес	Илес	F
Ілияс	Илияс	M
Ілияс	Ильяс	M
Ілімқан	Илимкан	F
Інжу	Инжу	F
Інжү	Инжу	F
Іңкәр	Инкар	F
Іңкәр	Инкар	M
Іңкәрбек	Инкарбек	M
Ісембек	Сембек	M
Ісмет	Исмет	M
Ісмет	Смет	M
Қабира	Кабира	F
Қадырбай	Кадырбай	M
Қазбек	Казбек	M
Қазтуған	Казтуган	M
Қайырбай	Каирбай	M
Қайыркен	Каиркен	M
Қалипа	Халипа	F
Қалкен	Калкен	M
Қалыбай	Калыбай	M
Қалыбек	Калыбек	M
Қамал	Камал	M
Қамар	Камар	M
Қамалиден	Камалиден	M
Камалия	Камалия	F
Қамбар	Камбар	M
Камен	Камен	M
Кәмшат	Камшат	F
Карина	Карина	F
Қарпық	Карпык	M
Кекіл	Кекил	M
Кекіл	Кекиль	M
Кекілбай	Кекильбай	M
Келбет	Келбет	F
Келбет	Кельбет	F
Келдібай	Келдибай	M
Келжан	Кельжан	M
Келіс	Келис	M
Кемел	Кемель	M
Кемелбай	Кемельбай	M
Кемелбек	Кемельбек	M
Кемен	Кемен	M
Кемеңгер	Кеменгер	M
Кенар	Кенар	M
Кенбай	Кенбай	M
Кендібай	Кендыбай	M
Кенен	Кенен	M
Кененбай	Кененбай	M
Кенжалы	Кенжали	M
Кенже	Кенже	F
Кенже	Кенже	M
Кенжебай	Кенжебай	M
Кенжебек	Кенжебек	M
Кенжеғали	Кенжегали	M
Кенжеғара	Кенжегара	M
Кенжеғұл	Кенжегул	M
Кенжекей	Кенжекей	F
Кенжетай	Кенжетай	M
Кенжехан	Кенжехан	F
Кентбай	Кентбай	M
Кеншінбай	Кеншинбай	M
Кеңес	Кенес	M
Кеңесбай	Кенесбай	M
Кеңесгүл	Кенесгуль	F
Кеңесхан	Кенесхан	F
Кеңшілік	Кеншилик	M
Керей	Керей	M
Керім	Керим	M
Керімбай	Керимбай	M
Керімбала	Керимбала	F
Керімбек	Керимбек	M
Керімсал	Керимсал	F
Кетей	Кетей	M
Кәде	Каде	M
Кәделі	Кадели	F
Кәден	Каден	F
Кәдима	Кадима	F
Кәдір	Кадир	M
Кәдірбай	Кадирбай	M
Кәдірбек	Кадирбек	M
Кәдіржан	Кадиржан	M
Кәдірқан	Кадирхан	M
Кәдіртай	Кадиртай	M
Кәжденбек	Кажденбек	M
Кәжімбай	Кажимбай	M
Кәкен	Какен	M
Кәкима	Какима	F
Кәкімжан	Какимжан	M
Кәкімтай	Какимтай	M
Кәкітай	Какитай	M
Кәмеш	Камеш	F
Кәмила	Камила	F
Кәмия	Камия	F
Кәмілбек	Камильбек	M
Кәрбоз	Карбоз	M
Кәрима	Карима	F
Кәрім	Карим	M
Кәрімжан	Каримжан	M
Кәрмен	Кармен	M
Кәсира	Касира	F
Кәтима	Катима	F
Кәусәр	Каусар	F
Киікбай	Киикбай	M
Киікбай	Кийкбай	M
Кінәр	Кинар	F
Кішібек	Кшибек	M
Клавдия	Клавдия	F
Клара	Клара	F
Космосбек	Космосбек	M
Көбей	Кобей	M
Көбейсін	Кобейсин	M
Көбейсін	Кубейсин	M
Көбейхан	Кубейхан	M
Көбен	Кубен	M
Көбен	Кобен	M
Көбік	Кобик	M
Көде	Коде	M
Көдек	Кодек	M
Көжек	Кожек	M
Көкбай	Кокбай	M
Көкеман	Кокеман	M
Көлбай	Кульбай	M
Көлбай	Кольбай	M
Көмекбай	Комекбай	M
Көпбай	Копбай	M
Көпжан	Копжан	M
Көпжан	Кобжан	M
Көпжасар	Копжасар	M
Көрік	Корик	M
Көркемжан	Коркемжан	M
Көшек	Кушек	M
Көшек	Кошек	M
Көшен	Кошен	M
Күбара	Кубара	F
Күбира	Кубира	F
Күдіре	Кудре	M
Күлай	Кулай	F
Күлайма	Кулайма	F
Күлайна	Кулайна	F
Күлайхан	Куляйхан	F
Күлайша	Куляйша	F
Күлайша	Кулайша	F
Күлапан	Кулапан	F
Күлапараз	Кулапараз	F
Күлбағила	Кульбагила	F
Күлбағира	Кульбагира	F
Күлбағиша	Қульбагиша	F
Күлбала	Кульбала	F
Күлбала	Кулбала	M
Күлбану	Кульбану	F
Күлбаһрам	Кульбахрам	F
Күлбара	Кульбара	F
Күлбаршын	Кульбаршин	F
Күлғайша	Кульгайша	F
Күлгін	Кульгин	F
Күлдана	Кульдана	F
Күлдара	Кульдара	F
Күлдария	Кульдария	F
Күлен	Кулен	M
Күләй	Кулай	F
Күләйхан	Кулайхан	F
Күлән	Кулян	F
Күләнда	Кулянда	F
Күләсия	Куласия	F
Күләш	Куляш	F
Күлжанат	Кульжанат	F
Күлжаукен	Кульжаукен	F
Күлжәми	Кульжами	F
Күлзада	Кульзада	F
Күлзайра	Кульзайра	F
Күлзәбира	Кульзабира	F
Күлзина	Кульзина	F
Күлзинат	Кульзинат	F
Күлзипа	Кульзипа	F
Күлзира	Кульзира	F
Күлзия	Кульзия	F
Күлила	Кулила	F
Күлиман	Кулиман	F
Күлипа	Кулипа	F
Күлира	Кулира	F
Күлия	Кулия	F
Күлімжан	Кулимжан	F
Күлімқан	Кулимхан	F
Күлкен	Кулкен	M
Күлмәрия	Кульмария	F
Күлпан	Кульпан	F
Күлпаш	Кульпаш	F
Күлсағила	Кульсагила	F
Күлсара	Кульсара	F
Күлсін	Кульсин	F
Күлтай	Культай	F
Күлшай	Кульшай	F
Күлшайым	Кульшаим	F
Күлшар	Кульшар	F
Күлшара	Кульшара	F
Күлшаруан	Кульшаруан	F
Күлшархан	Кульшархан	F
Күлшатай	Кульшатай	F
Күміс	Кумис	F
Күмісай	Кумисай	F
Күмісбай	Кумисбай	M
Күмісбек	Кумисбек	M
Күмісбике	Кумисбике	F
Күнай	Кунай	F
Күнайым	Кунаим	F
Күнбала	Кунбала	F
Күндар	Кундар	M
Күнжан	Кунжан	F
Күнзира	Кунзира	F
Күнипй	Кунипа	F
Күния	Куния	F
Күнікей	Куникей	F
Күнке	Кунке	F
Күнсара	Кунсара	F
Күнсұлу	Кунсулу	F
Күнтай	Кунтай	M
Күнту	Кунту	M
Күнтуар	Кунтуар	M
Кұрмет	Хурмет	M
Кұрмет	Курмет	M
Қабаз	Кабаз	M
Қабай	Кабай	M
Қабанбай	Кабанбай	M
Қабас	Кабас	M
Қабден	Кабден	M
Қабдол	Кабдол	M
Қабжан	Кабжан	M
Қаби	Каби	M
Қабиба	Хабиба	F
Қабыкен	Кабкен	M
Қабыл	Кабыл	M
Қабылбек	Кабулбек	M
Қабылбек	Кабылбек	M
Қадиша	Кадиша	F
Қадия	Кадия	F
Қадылша	Кадылша	F
Қадыр	Кадыр	M
Қадырбай	Кадырбай	M
Қадырбек	Кадырбек	M
Қадырғали	Кадыргали	M
Қадыржан	Кадыржан	M
Қадырқан	Кадыркан	M
Қадырхан	Қадырхан	F
Қадырша	Кадырша	F
Қажыбай	Кажибай	M
Қажыбек	Кажибек	M
Қажығали	Кажигали	M
Қажым	Хажим	M
Қажымұқан	Кажимухан	M
Қажымұрат	Кажимурат	M
Қажыр	Кажир	M
Қазақбай	Казакбай	M
Қази	Кази	M
Қазиза	Казиза	F
Қазила	Казила	F
Қазима	Казима	F
Қазира	Казира	F
Қазкен	Казкен	M
Қазтай	Казтай	M
Қазыбай	Казыбай	M
Қазыбек	Казыбек	M
Қазымбек	Казымбек	M
Қазымхан	Казымхан	M
Қазына	Казына	F
Қазына	Казна	F
Қазыхан	Казыхан	M
Қаииза	Каниза	F
Қайдар	Хайдар	M
Қайдар	Кайдар	M
Қайназар	Кайназар	M
Қайнарбай	Кайнарбай	M
Қайнұр	Кайнур	M
Қайныш	Кайниш	F
Қайрат	Кайрат	M
Қайсар	Кайсар	M
Қайсен	Кайсен	M
Қайша	Кайша	F
Қайым	Каим	M
Қайып	Каип	M
Қайыпбек	Каипбек	M
Қайыпғали	Каипгали	M
Қайыпжан	Каипжан	M
Қайыр	Каир	M
Қайырбек	Каирбек	M
Қайырболат	Каирболат	M
Қайырғазы	Каиргазы	M
Қайырғали	Каиргали	M
Қайыргелді	Кайыргелди	M
Қайыргелді	Каиргельды	M
Қайыржамал	Кайыржамал	F
Қайыржан	Каиржан	M
Қайырке	Каирке	M
Қайырлы	Каиртай	M
Қайыртай	Каиртай	M
Қалабай	Калабай	M
Қаламбай	Каламбай	M
Қаламқас	Каламкас	F
Қалампыр	Калампыр	F
Қалантай	Калантай	F
Қалау	Калау	M
Қалауша	Калауша	M
Қалбибі	Калбиби	F
Қалбике	Қалбике	F
Қалдарбек	Калдарбек	M
Қалдораз	Калдораз	M
Қалдыбай	Калдыбай	M
Қалдығара	Калдыгара	M
Қали	Кали	M
Қалибек	Калибек	M
Қалила	Халила	F
Қалима	Халима	F
Қалимат	Халимат	F
Қалисан	Калисан	M
Қалит	Калит	M
Қалихан	Алихан	M
Қалия	Калия	F
Қалия	Халия	F
Қалқа	Калка	M
Қалқаман	Калкаман	M
Қалмақан	Калмакан	M
Қалмат	Калмат	M
Қалмырза	Калтай	M
Қалтай	Калыбай	M
Қалтұрған	Калтурган	F
Қалуа	Калуа	F
Қалуа	Халуа	F
Қалуан	Калуан	F
Қалыбай	Калыбай	M
Қалыбек	Калыбек	M
Қалығұл	Калыгул	M
Қалымбет	Калымбет	M
Қамал	Камал	M
Қамария	Камария	F
Қамарниса	Қамарниса	F
Қамарша	Камарша	F
Қамбар	Камыс	M
Қамқа	Камка	F
Қамқай	Камкай	F
Қамыс	Камыс	M
Қанабек	Канабек	M
Қанағат	Канагат	M
Қаназ	Каназ	M
Қанай	Канай	M
Қанайбек	Канайбек	M
Қанапия	Канапия	F
Қанат	Канат	M
Қанатбай	Канатбай	M
Қанафия	Канафия	M
Қаныбай	Каныбай	M
Қаныш	Каныш	F
Қанзиба	Канзиба	F
Қанипа	Канипа	F
Қантгүл	Кантгуль	F
Қаншайым	Ханшаим	F
Қапан	Капан	M
Қапар	Капар	M
Қапиза	Капиза	M
Қарабала	Карабала	F
Қарабек	Карабек	M
Қарагөз	Карагоз	F
Қарағұл	Карагул	M
Қаражан	Каражан	M
Қараман	Караман	M
Қарас	Карас	M
Қарасай	Карасай	M
Қаратай	Каратай	M
Қараш	Караш	M
Қаржас	Каржас	M
Қаржау	Каржау	M
Қари	Кари	M
Қармыс	Кармыс	M
Қарлыға	Карлыга	F
Қарлығаш	Карлыгаш	F
Қарсен	Карсен	M
Қарша	Карша	F
Қаршыға	Каршыга	M
Қасиман	Касиман	M
Қаскей	Каскей	M
Қасқабас	Каскабас	M
Қасым	Касым	M
Қасымбай	Касымбай	M
Қасымбек	Касымбек	M
Қасымжан	Касымжан	M
Қасымхан	Касымхан	M
Қатаған	Катаган	M
Қатай	Катай	M
Қатипа	Катипа	F
Қатира	Катира	F
Қатиф	Катиф	M
Қатшагүл	Катшагуль	F
Қауа	Хауа	F
Қаумен	Каумен	M
Қауымбек	Каумбай	M
Қашифа	Кашифа	F
Қашия	Кашия	F
Қаһарман	Кахарман	M
Қибаш	Кибаш	M
Қизат	Кизат	M
Қилым	Килым	M
Қирабай	Кирабай	M
Қияқбай	Киякбай	M
Қиясбай	Киясбай	M
Қобдабай	Кобдабай	M
Қобыланды	Кобланды	M
Қоғамбай	Когамбай	M
Қоғамбек	Когамбек	M
Қожа	Кожа	M
Қожабай	Кожабай	M
Қожабек	Кожабек	M
Қожаберген	Кожаберген	M
Қожағали	Кожагали	M
Қожағұл	Кожагул	M
Қожакей	Кожакей	M
Қожақ	Кожак	M
Қожақан	Кожахан	M
Қожамқұл	Кожамкул	M
Қожахмет	Кожахмет	M
Қожаш	Кожаш	M
Қожбан	Кожбан	M
Қожық	Кожик	M
Қозы	Козы	M
Қозыбай	Козыбай	M
Қойбағар	Койбагар	M
Қойдос	Койдос	M
Қойлыбай	Койлыбай	M
Қойшыбай	Койшибай	M
Қойшығара	Койшигара	M
Қолғанат	Колганат	M
Қолдас	Колдас	M
Қонай	Кунай	M
Қонакбай	Конакбай	M
Қонақ	Конак	M
Қоныс	Коныс	M
Қонысбай	Конысбай	M
Қоңыр	Конур	M
Қоңыр	Коныр	M
Қоңырбай	Конурбай	M
Қоңырбай	Конырбай	M
Қорғанбек	Корганбек	M
Қорғасбай	Коргасбай	M
Қордабай	Кордабай	M
Қорлан	Корлан	F
Қорлан	Хорлан	F
Қосай	Косай	M
Қосбасар	Косбасар	M
Қосжан	Косжан	M
Қосман	Косман	M
Қосназар	Косназар	M
Қосыбай	Косыбай	M
Қосын	Косын	M
Қосынбай	Косынбай	M
Қошқарбай	Кошкарбай	M
Қөбеген	Кобеген	M
Қуан	Куан	M
Қуанбай	Куанбай	M
Қуанғали	Куангали	M
Қуандық	Куандык	M
Қуаныш	Куаныш	M
Қуанышбай	Куанышбай	M
Қуат	Куат	M
Қуатбек	Куатбек	M
Қүніш	Куниш	F
Қүрмаш	Курмаш	M
Құбай	Кубай	M
Құбан	Кубан	M
Құдайберген	Кудайберген	M
Құдас	Кудас	M
Құдаш	Кудаш	M
Құдияр	Кудияр	M
Құдыс	Кудыс	M
Құланбай	Куланбай	M
Құлмағамбет	Кулмагамбет	M
Құлшын	Кулшин	M
Құлыншақ	Кулыншак	M
Құмар	Кумар	M
Құмарбек	Кумарбек	M
Құнар	Кунар	M
Құндыз	Кундыз	F
Құндыз	Кундуз	F
Құрал	Курал	M
Құралай	Куралай	F
Құралбай	Куралбай	M
Құралбек	Куралбек	M
Құрбан	Курбан	M
Құрбанғали	Курбангали	M
Құрбике	Курбике	F
Құрман	Курман	M
Құрманай	Курманай	M
Құрманбай	Курманбай	M
Құрманбек	Курманбек	M
Құрманғазы	Курмангазы	M
Құрманғали	Курмангали	M
Құрманәлі	Курманали	M
Құрмантай	Курмантай	M
Құрмет	Курмет	M
Құртқа	Куртха	F
Құрышжан	Курышжан	M
Құсайын	Кусайын	M
Құсайынбек	Кусаинбек	M
Құсбек	Кусбек	M
Құсман	Кусман	M
Құсманғали	Кусмангали	M
Құтан	Кутан	M
Құтел	Кутел	M
Құтжан	Кутжан	M
Құтқали	Куткали	M
Құтқожа	Кутхожа	M
Құттыбай	Куттыбай	M
Құттыбек	Куттыбек	M
Құттыгүл	Куттыгуль	F
Құттық	Куттык	M
Құттықадам	Куттыкадам	M
Құттымбек	Куттымбек	M
Қыдыр	Кыдыр	M
Қыдырбай	Кыдырбай	M
Қыдырбек	Кыдырбек	M
Қыдырғали	Кыдыргали	M
Қыдырәлі	Кыдырали	M
Қызғалдақ	Кызгалдак	F
Қызықбай	Кызыкбай	M
Қызылкүл	Кызылкуль	F
Қылыш	Клыш	M
Қымбат	Кымбат	F
Қынакүл	Кынакуль	F
Қыраубай	Кыраубай	M
Қырмызы	Кырмызы	F
Қырымқұл	Кырымкул	M
Лазым	Лазым	F
Лала	Лала	F
Ларида	Ларида	F
Лариса	Лариса	F
Латиф	Латиф	M
Лаула	Лаула	F
Лаура	Лаура	F
Лашын	Лашин	F
Легия	Легия	F
Лейла	Лейла	F
Лекер	Лекер	M
Лена	Лена	F
Лепес	Лепес	M
Лешкер	Лешкер	M
Ләбиба	Лабиба	F
Ләззат	Ляззат	F
Ләзиза	Лазиза	F
Ләзиза	Лязиза	F
Ләйла	Лайла	F
Ләйла	Ляйла	F
Ләйлім	Ляйлим	F
Ләмзия	Ламзия	F
Ләсима	Ласима	F
Ләтипа	Латипа	F
Ләтипа	Латифа	F
Ләшкер	Лашкер	M
Ләшкербек	Лашкербек	M
Лиана	Лиана	F
Лида	Лида	F
Лидия	Лидия	F
Лиза	Лиза	F
Лила	Лила	F
Лилия	Лилия	F
Лира	Лира	F
Лойза	Лойза	F
Лола	Лола	F
Лора	Лора	F
Лорида	Лорида	F
Лота	Лота	F
Луиза	Луиза	F
Лутфолла	Лутфулла	M
Лұқпан	Лукпан	M
Лэра	Лэра	F
Людмила	Людмила	F
Люция	Люция	F
Мағаз	Магаз	M
Мағауия	Магауия	M
Мағзия	Магзия	F
Мағзұм	Магзум	M
Мағила	Магила	F
Мағира	Магира	F
Мағиша	Магиша	F
Мағрипа	Магрипа	F
Мағриса	Магриса	F
Мағруф	Магруф	M
Мағымура	Магмура	F
Мағыпар	Магыпар	M
Мадан	Мадан	M
Мадәзім	Мадазим	M
Мадәлі	Мадали	M
Мадияр	Мадияр	M
Мажыра	Мажра	M
Майгүл	Майгуль	F
Майда	Майда	F
Майдан	Майдан	M
Майемер	Майемер	M
Майиса	Майиса	F
Майқан	Майхан	M
Майқы	Майки	M
Майлы	Майлы	M
Майлыбай	Майлыбай	M
Майман	Майман	M
Майна	Майна	F
Майнұр	Майнур	F
Майпа	Майпа	F
Майра	Майра	F
Майса	Майса	F
Майсара	Майсара	F
Майтан	Майтан	M
Майташ	Майташ	F
Майтжан	Майтжан	M
Майша	Майша	F
Майя	Майя	F
Мақабай	Макабай	M
Мақабыл	Макабыл	M
Мақажан	Макажан	M
Мақай	Макай	M
Мақан	Макан	M
Мақат	Макат	M
Мақатай	Макатай	M
Мақаш	Макаш	M
Мақпал	Макпал	F
Мақсат	Максат	M
Мақсума	Максума	F
Мақсұм	Максум	M
Мақсұт	Максут	M
Мақсұтбай	Максутбай	M
Мақсым	Максим	M
Мақтан	Мактан	M
Мақұлбек	Макулбек	M
Мақфуза	Махфуза	F
Малбағар	Малбагар	M
Малбай	Малбай	M
Малбек	Малбек	M
Малғара	Малгара	M
Малгелді	Малгельды	M
Малғозы	Малгозы	M
Малдыбай	Малдыбай	M
Малжан	Малжан	M
Малкен	Малкен	M
Малқар	Малкар	M
Малмақ	Малмак	M
Малтабар	Малтабар	M
Малыбай	Малыбай	M
Мамадияр	Мамадияр	M
Мамажан	Мамажан	M
Мамай	Мамай	M
Маман	Маман	M
Мамасадық	Мамасадык	M
Мамасейіт	Мамасеит	M
Мамат	Мамат	M
Мамбет	Мамбет	M
Мамық	Мамык	F
Мамыр	Мамыр	M
Мамырай	Мамырай	M
Мамырхан	Мамырхан	M
Мамыт	Мамыт	M
Мамытбек	Мамытбек	M
Манабай	Манабай	M
Манан	Манан	M
Манап	Манап	M
Манапбай	Манапбай	M
Манапбек	Манапбек	M
Манар	Манар	M
Манар	Манар	F
Манарбек	Манарбек	M
Манас	Манас	M
Манасбай	Манасбай	M
Манасбек	Манасбек	M
Манат	Манат	F
Манат	Манат	M
Манау	Манау	M
Манаш	Манаш	M
Манзура	Манзура	F
Маниға	Манига	F
Манила	Манила	F
Мансура	Мансура	F
Мансұр	Мансур	M
Мантай	Мантай	M
Маңғытай	Мангитай	M
Маплы	Маплы	M
Мара	Мара	F
Марабай	Марабай	M
Марал	Марал	F
Маралбай	Маралбай	M
Марасұл	Марасул	M
Марат	Марат	M
Маратбек	Маратбек	M
Марғайша	Маргайша	F
Маргарита	Маргарита	F
Марго	Марго	F
Мардан	Мардан	M
Мареш	Мареш	F
Маржан	Маржан	F
Маржанкүл	Маржангуль	F
Марзия	Марзия	F
Мариана	Мариана	F
Марина	Марина	F
Мария	Мария	F
Мариям	Мариям	F
Мариямбике	Мариямбике	F
Мариямкүл	Мариямгуль	F
Марияш	Марияш	F
Маркасқа	Маркаска	M
Маркиза	Маркиза	F
Марқа	Марха	F
Марқай	Маркай	M
Марқас	Маркас	M
Марлен	Марлен	M
Марлена	Марлена	F
Марс	Марс	M
Марсбек	Марсбек	M
Марсел	Марсель	M
Мартбек	Мартбек	M
Маруа	Маруа	F
Маруаза	Маруаза	F
Марфуға	Марфуга	F
Мархаба	Мархаба	F
Мархабай	Мархабай	M
Мархабат	Мархабат	M
Маршал	Маршал	M
Масан	Масан	M
Масат	Масат	M
Масаты	Масаты	F
Масқұт	Маскут	M
Масқұт	Масхут	M
Мастура	Мастура	F
Матай	Матай	M
Матақай	Матакай	M
Матлан	Матлан	M
Матлуба	Матлуба	F
Матуза	Матуза	F
Мауан	Мауан	M
Мауқида	Маукида	F
Маура	Маура	F
Маусымбай	Маусымбай	M
Маусымжан	Маусымжан	F
Махамбет	Махамбет	M
Махбала	Махбала	F
Махбара	Махбара	F
Махбүбі	Махбуби	F
Махзада	Махзада	F
Махинур	Махинур	F
Махинүр	Махинур	F
Махмет	Махмет	M
Махмут	Махмут	M
Махмұт	Махмут	M
Маху	Маху	M
Махфуза	Махфуза	F
Махфура	Махфура	F
Машабай	Машабай	M
Машақ	Машак	M
Машан	Машан	M
Машрап	Машрап	M
Мая	Мая	F
Медел	Медел	M
Медербай	Медербай	M
Медет	Медет	M
Медетбай	Медетбай	M
Медетбек	Медетбек	M
Медетнар	Медетнар	M
Медетхан	Медетхан	M
Медеу	Медеу	M
Медеубек	Медеубек	M
Медхат	Медхат	M
Мейіз	Мейиз	F
Мейіз	Меиз	F
Мейізгүл	Меизгуль	F
Мейір	Мейир	M
Мейір	Меир	M
Мейірбек	Мейирбек	M
Мейіржан	Мейиржан	F
Мейіржан	Меиржан	F
Мейіржан	Меиржан	M
Мейірман	Мейирман	M
Мейірман	Меирман	M
Мейірхан	Меирхан	M
Мейман	Мейман	M
Мейманкүл	Мейманкуль	F
Мейрам	Мейрам	M
Мейрамгүл	Мейрамгуль	F
Мейрамқан	Мейрамкан	F
Мейраш	Мейраш	F
Мекебай	Мекебай	M
Мекемтас	Мекемтас	M
Менаш	Менаш	M
Мең	Мен	M
Меңдахмет	Мендахмет	M
Меңдеш	Мендеш	M
Меңдібай	Мендибай	M
Меңдібай	Мендыбай	M
Меңдіғали	Мендыгали	M
Меңжамал	Менжамал	F
Меңлахмет	Менлиахмет	M
Мерген	Мерген	M
Мергенбай	Мергенбай	M
Мерей	Мерей	M
Мерейлі	Мерейли	F
Мереке	Мереке	F
Мереке	Мереке	M
Мерзия	Мерзия	F
Меруерт	Меруерт	F
Мәдахмет	Мадахмет	M
Мәдел	Мадел	M
Мәден	Маден	M
Мәдениет	Мадениет	M
Мәдәзім	Мадазим	M
Мәдәлі	Мадали	M
Мәди	Мади	M
Мәдина	Мадина	F
Мәдит	Мадит	M
Мәдия	Мадия	F
Мәді	Мади	M
Мәдібала	Мадибала	F
Мәдхан	Мадхан	M
Мәдхат	Мадхат	M
Мәжғұл	Мажгул	M
Мәжен	Мажен	M
Мәжила	Мажила	F
Мәжит	Мажит	M
Мәжіт	Мажит	M
Мәкен	Макен	F
Мәкила	Макила	F
Мәлике	Малике	F
Мәлике	Малика	F
Мәлік	Малик	M
Мәлікайдар	Маликайдар	M
Мәлім	Малим	M
Мәмбек	Мамбек	M
Мәмбет	Мамбет	M
Мәмен	Мамен	M
Мәмет	Мамет	M
Мәмила	Мамила	F
Мәндула	Мандула	F
Мәнеке	Манеке	M
Мәнзила	Манзила	F
Мәнзипа	Манзипа	F
Мәнке	Манке	M
Мәнсия	Мансия	F
Мәнсура	Мансура	F
Мәнуза	Мануза	F
Мәншүк	Маншук	F
Мәрзила	Марзила	F
Мәрзия	Марзия	F
Мәриямкүл	Мариямкуль	F
Мәрмара	Мармара	F
Мәсе	Масе	M
Мәсімбай	Масимбай	M
Мәскей	Маскей	M
Мәстура	Мастура	F
Мәтби	Матби	M
Мәтен	Матен	F
Мәтжан	Матжан	M
Мәтібай	Матибай	M
Мәтібәлі	Матибали	M
Мәтіби	Матиби	M
Мәткерім	Маткарим	M
Мәткәрім	Маткарим	M
Мәтқасым	Маткасым	M
Мәтхалық	Матхалык	M
Мәуе	Мауе	F
Мәуия	Мауия	F
Мәукен	Маукен	M
Мәулен	Маулен	M
Мәулет	Маулет	M
Мәулетбай	Маулетбай	M
Мәшей	Машей	M
Мәшірбай	Маширбай	M
Мәшкей	Машкей	M
Мәшһүр	Машхур	M
Мизам	Мизам	M
Мимоза	Мимоза	F
Мира	Мира	F
Мирас	Мирас	M
Мират	Мират	M
Мирболат	Мирболат	M
Миргали	Миргали	M
Мирғали	Миргали	M
Миржан	Миржан	M
Миркәрім	Миркарим	M
Мирон	Мирон	M
Миртай	Миртай	M
Мирхайдар	Мирхайдар	M
Мият	Мият	M
Миятжан	Миятжан	M
Мінайдар	Минайдар	M
Мінаура	Мнаура	F
Мінипа	Мнипа	F
Молбай	Молбай	M
Молдабай	Молдабай	M
Молдабек	Мулдабек	M
Молдабек	Молдабек	M
Молдағали	Мулдагали	M
Молдағали	Молдагали	M
Молдан	Молдан	M
Молдасан	Молдасан	M
Молдахан	Молдахан	M
Молдахмет	Молдахмет	M
Молдаш	Молдаш	M
Молдырахман	Молдрахман	M
Молжан	Молжан	M
Молты	Молты	M
Молыбай	Молыбай	M
Момбек	Момбек	M
Момынәлі	Момынали	M
Момыш	Момыш	M
Монтай	Монтай	M
Моштай	Моштай	M
Мояз	Мояз	M
Мөкей	Мокей	M
Мөлтек	Молтек	M
Мөңке	Монке	M
Муза	Муза	F
Мунира	Мунира	F
Мүбәрак	Мубарак	M
Мүбина	Мубина	F
Мүккарима	Муккарима	F
Мүлипа	Мулипа	F
Мүнира	Мунира	F
Мүрсейіт	Мурсейит	M
Мүрсейіт	Мурсеит	M
Мүрсәлім	Мурсалим	M
Мүсабек	Мусабек	M
Мүсен	Мусен	M
Мүсәлім	Мусалим	M
Мүсір	Мусир	M
Мүсіреп	Мусиреп	M
Мүсіреп	Мусреп	M
Мүсірәлі	Мусирали	M
Мүтәліп	Муталип	M
Мүткен	Муткен	M
Мүштәри	Муштари	F
Мүштәри	Мухтари	F
Мұзафар	Музафар	M
Мұкамәди	Мухамади	M
Мұкаррама	Мукаррама	F
Мұқа	Мука	M
Мұқағали	Мукагали	M
Мұқаділ	Мукадил	M
Мұқажан	Мукажан	M
Мұқай	Мукай	M
Мұқали	Мукали	M
Мұқамади	Мухамади	M
Мұқамбек	Мухамбек	M
Мұқамбет	Мукамбет	M
Мұқамбет	Мухамбет	M
Мұқамедия	Мухамедья	M
Мұқаметғали	Мухаметгали	M
Мұқаметжан	Мухаметжан	M
Мұқаметхан	Мухаметхан	M
Мұқамәди	Мукамади	M
Мұқамәлі	Мухамали	M
Мұқат	Мухат	M
Мұқатай	Мухатай	M
Мұқаш	Мукаш	M
Мұқтан	Муктан	M
Мұқым	Мукым	M
Мұрабай	Мурабай	M
Мұрақан	Муракан	M
Мұрас	Мурас	M
Мұрат	Мурат	M
Мұратбай	Муратбай	M
Мұратбек	Муратбек	M
Мұратәлі	Муратали	M
Мұратхан	Муратхан	M
Мұртаза	Муртаза	M
Мұса	Муса	M
Мұсабай	Мусабай	M
Мұсағали	Мусагали	M
Мұсағұл	Мусагул	M
Мұсажан	Мусажан	M
Мұсайын	Мусаин	M
Мұсақан	Мусахан	M
Мұсақожа	Мусахожа	M
Мұсатай	Мусатай	M
Мұсахмет	Мусахмет	M
Мұстан	Мустан	M
Мұстанай	Мустанай	M
Мұстариз	Мустариз	M
Мұстафа	Мустафа	M
Мұстахиб	Мустахиб	M
Мұстахим	Мустахим	M
Мұхамбетәзіз	Мухамбетазиз	M
Мұхамбетжан	Мухамбетжан	M
Мұхамедияр	Мухамедияр	M
Мұхит	Мухит	M
Мұхитан	Мухитан	M
Мұхтар	Мухтар	M
Мұхтарима	Мухтарима	F
Мығым	Мыгым	M
Мықтыбай	Мыктыбай	M
Мыңбай	Мынбай	M
Мырзабай	Мырзабай	M
Мырзабек	Мырзабек	M
Мырзағұл	Мырзагул	M
Мырзалы	Мурзали	M
Мырзамәди	Мурзамади	M
Мырзамәди	Мырзамади	M
Мырзарахман	Мырзарахман	M
Мырзатай	Мырзатай	M
Мырзахмет	Мырзахмет	M
Мырқайдар	Мирхайдар	M
Мырқасым	Мыркасым	M
Мырқасым	Миркасым	M
Мырхайдар	Мырхайдар	M
Мысқал	Мыскал	F
Мышбай	Мышбай	M
Мышырбай	Мышырбай	M
Нағашбай	Нагашбай	M
Нағашбек	Нагашбек	M
Нағашыбай	Нагашибай	M
Нағи	Наги	M
Нағиза	Нагиза	F
Нағила	Нагила	F
Нағима	Нагима	F
Нағиша	Нагиша	F
Нағмет	Нагмет	M
Нағым	Нагым	M
Нағым	Нагим	M
Нағымбек	Нагымбек	M
Нағымбек	Нагимбек	M
Надира	Надира	F
Назар	Назар	M
Назарбай	Назарбай	M
Назарбек	Назарбек	M
Назарәлі	Назарали	M
Назгүл	Назгуль	F
Назиба	Назиба	F
Назиза	Назиза	F
Назира	Назира	F
Назия	Назия	F
Назтай	Назтай	M
Назыгүл	Назыгуль	F
Назым	Назым	F
Назырбай	Назирбай	M
Найзабек	Найзабек	M
Найманбай	Найманбай	M
Найманбек	Найманбек	M
Найра	Найра	F
Нақан	Накан	M
Нақып	Накып	M
Нақысбек	Накысбек	M
Нақысбек	Накисбек	M
Нақыш	Накиш	M
Нарбай	Нарбай	M
Нарбек	Нарбек	M
Нарбол	Нарбол	M
Нарбота	Нарбота	M
Нардан	Нардан	M
Наржан	Наржан	M
Нариман	Нариман	M
Наркен	Наркен	M
Наркес	Наркес	M
Нарқуат	Наркуат	M
Нармағамбет	Нармагамбет	M
Нармамбет	Нармамбет	M
Нармат	Нармат	M
Нартай	Нартай	M
Нартау	Нартау	M
Нартоқ	Нарток	M
Нарту	Нарту	M
Нарша	Нарша	F
Наршат	Наршат	M
Наршын	Наршин	M
Нарымбет	Нарымбет	M
Нарымжан	Нарымжан	M
Насан	Насан	M
Насыр	Насыр	M
Насырбай	Насырбай	M
Наталья	Наталья	F
Науан	Науан	M
Науат	Науат	F
Наудан	Наудан	M
Наурыз	Наурыз	M
Наурыз	Науруз	M
Наурызбай	Наурузбай	M
Наурызбай	Наурызбай	M
Наурызбек	Наурызбек	M
Наурызбек	Наурузбек	M
Наурызғали	Наурузгали	M
Наурызғали	Наурызгали	M
Науша	Науша	F
Неғим	Негим	M
Неля	Неля	F
Несіп	Несип	M
Несіпбай	Несипбай	M
Несіпбек	Несипбек	M
Несіпжан	Несипжан	F
Нетәлі	Нетали	M
Нетқали	Неткали	M
Нәби	Наби	M
Нәбиболла	Набиболла	M
Нәбиден	Набиден	M
Нәбиолла	Набиулла	M
Нәбира	Набира	F
Нәбия	Набия	F
Нәдира	Надира	F
Нәдия	Надия	F
Нәдір	Надир	M
Нәдірбай	Надирбай	M
Нәдірбек	Надирбек	M
Нәжіп	Нажип	M
Нәзипа	Назипа	F
Нәзира	Назира	F
Нәзір	Назир	M
Нәзірбек	Назирбек	M
Нәзірвек	Назирбек	M
Нәйла	Найла	F
Нәйла	Найля	F
Нәлғара	Нальгара	M
Нәргүл	Наргуль	F
Нәрзән	Нарзан	F
Нәрима	Нарима	F
Нәрік	Нарик	M
Нәрікбай	Нарикбай	M
Нәсима	Насима	F
Нәфиса	Нафиса	F
Ниет	Ниет	M
Ниетбай	Ниетбай	M
Ниетқали	Ниеткали	M
Ниетолла	Ниетулла	M
Низам	Низам	M
Нина	Нина	F
Нияз	Нияз	M
Ниязбек	Ниязбек	M
Ниязмұхамбет	Ниязмухамбет	M
Нілжан	Нильжан	F
Нілібай	Нилибай	M
Ноғайбай	Ногайбай	M
Ноиль	Ноиль	M
Ноян	Ноян	M
Ноянбай	Ноянбай	M
Нөкербек	Нокербек	M
Нурқа	Нурка	F
Нүрғалым	Нургалым	M
Нүрәлі	Нурали	M
Нүрзия	Нурзия	F
Нүсіп	Нусип	M
Нүсіп	Нусуп	M
Нүсіпбек	Нусипбек	M
Нүсіпжан	Нусипжан	M
Нүсіпқан	Нусипхан	M
Нұғман	Нугман	M
Нұғыман	Нугман	M
Нұр	Нур	M
Нұрабай	Нурабай	M
Нұрай	Нурай	F
Нұрайдар	Нурайдар	M
Нұрайна	Нурайна	F
Нұрайша	Нурайша	F
Нұрақ	Нурак	M
Нұрақын	Нуракын	M
Нұралы	Нуралы	M
Нұран	Нуран	M
Нұрасыл	Нурасыл	F
Нұрахмет	Нурахмет	M
Нұраш	Нураш	M
Нұрбағила	Нурбагила	F
Нұрбай	Нурбай	M
Нұрбақ	Нурбак	M
Нұрбану	Нурбану	F
Нұрбапа	Нурбапа	M
Нұрбек	Нурбек	M
Нұрберген	Нурберген	M
Нұрбәкен	Нурбакен	M
Нұрбәти	Нурбати	F
Нұрбибі	Нурбиби	F
Нұрбибіш	Нурбибиш	F
Нұрбол	Нурбол	M
Нұрболат	Нурболат	M
Нұрболсын	Нурболсын	M
Нұрбосын	Нурбосын	M
Нұрғабыл	Нургабил	M
Нұрғазы	Нургазы	M
Нұрғайса	Нургайса	F
Нұрғайша	Нургайша	F
Нұрғайын	Нургаин	M
Нұрғали	Нургали	M
Нұрғалипа	Нургалипа	F
Нұрғалым	Нургалим	M
Нұрғаным	Нурганым	F
Нұргеді	Нургеди	M
Нұргелді	Нургельды	M
Нұрғизар	Нургизар	M
Нұрғиса	Нургиса	M
Нұргүлсім	Нургульсим	F
Нұрда	Нурда	F
Нұрдан	Нурдан	M
Нұрден	Нурден	M
Нұрдәулет	Нурдаулет	M
Нұрділда	Нурдилда	M
Нұрек	Нурек	M
Нұрәділ	Нурадиль	M
Нұрәлі	Нурали	M
Нұржақан	Нуржакан	M
Нұржақан	Нуржахан	M
Нұржамал	Нуржамал	F
Нұржамила	Нуржамила	F
Нұржан	Нуржан	M
Нұржанат	Нуржанат	F
Нұржау	Нуржау	M
Нұржекей	Нуржекей	M
Нұржет	Нуржет	M
Нұржігіт	Нуржигит	M
Нұржұма	Нуржума	M
Нұрзада	Нурзада	M
Нұрзат	Нурзат	M
Нұрзерек	Нурзерек	M
Нұрзила	Нурзила	F
Нұрзия	Нурзия	F
Нұри	Нури	M
Нұриддин	Нуриддин	M
Нұрикамал	Нурикамал	F
Нұрила	Нурила	F
Нұрима	Нурима	F
Нұрипа	Нурипа	F
Нұрия	Нурия	F
Нұрке	Нурке	M
Нұрқаділ	Нуркадил	M
Нұрқайдар	Нуркайдар	M
Нұрқан	Нуркан	F
Нұрқасым	Нуркасым	M
Нұрқия	Нуркия	F
Нұрқияз	Нуркияз	M
Нұрлай	Нурлай	M
Нұрлан	Нурлан	M
Нұрлас	Нурлас	M
Нұрлат	Нурлат	M
Нұрлы	Нурлы	M
Нұрлыбай	Нурлыбай	M
Нұрлыбек	Нурлыбек	M
Нұрлығайын	Нурлигайн	M
Нұрлықан	Нурлыхан	F
Нұрлықұл	Нурлыкуль	F
Нұрлықыз	Нурлыкыз	F
Нұрмағамбет	Нурмагамбет	M
Нұрмақ	Нурмак	M
Нұрмақан	Нурмахан	M
Нұрмамбет	Нурмамбет	M
Нұрман	Нурман	F
Нұрмұқамбет	Нурмукамбет	M
Нұрмұхамбет	Нурмухамбет	M
Нұрнияз	Нурнияз	M
Нұрпейіс	Нурпейис	M
Нұрпейіс	Нурпеис	M
Нұрсапа	Нурсапа	M
Нұрсара	Нурсара	F
Нұрсая	Нурсая	F
Нұрсейіт	Нурсейит	M
Нұрсейіт	Нурсеит	M
Нұрсерке	Нурсерке	M
Нұрсипат	Нурсипат	F
Нұрсия	Нурсия	F
Нұрсовет	Нурсовет	M
Нұрсүлтан	Нурсултан	M
Нұрсұлтан	Нурсултан	M
Нұрсұлу	Нурсулу	F
Нұртаза	Нуртаза	M
Нұртай	Нуртай	M
Нұртайлақ	Нуртайлак	F
Нұрталап	Нурталап	M
Нұртан	Нуртан	M
Нұртас	Нуртас	M
Нұртілеу	Нуртлеу	M
Нұрхан	Нурхан	F
Нұрхан	Нурхан	M
Нұрша	Нурша	F
Нұршайык	Нуршайх	M
Нұршайым	Нуршайым	F
Нұршайым	Нуршайм	F
Нұршара	Нуршара	F
Нұршат	Нуршат	F
Нұрылда	Нурильда	M
Нұрым	Нурым	M
Нұрым	Нурум	M
Нұрымбет	Нурумбет	M
Нұрыш	Нуруш	M
Нұсқабай	Нускабай	M
Нұсқар	Нускар	M
Нұтфолла	Нутфулла	M
Нығмет	Ныгмет	M
Нығмет	Нигмет	M
Нығметжан	Ныгметжан	M
Нығметжан	Нигметжан	M
Нығметқали	Ныгметкали	M
Нығметқали	Нигметкали	M
Нығметолла	Ныгметолла	M
Нығметолла	Нигметулла	M
Нысан	Нысан	M
Нысаналы	Нысанали	M
Нысанбай	Нысанбай	M
Обай	Обай	M
Одар	Одар	M
Ожарбай	Ожарбай	M
Озарбек	Озарбек	M
Озария	Озария	F
Озат	Озат	M
Ойбек	Ойбек	M
Ойке	Ойке	F
Ойлы	Ойлы	M
Ойрат	Ойрат	M
Оксана	Оксана	F
Октябрина	Октябрина	F
Октябрь	Октябрь	M
Оқан	Окан	M
Оқас	Окас	M
Олжабай	Олжабай	M
Олжас	Олжас	M
Ольга	Ольга	F
Омар	Омар	M
Омарбай	Омарбай	M
Омарбек	Омарбек	M
Омарғазы	Омаргазы	M
Омарғали	Омаргали	M
Омархан	Омархан	M
Омаш	Омаш	M
Онай	Онай	M
Онбай	Онбай	M
Оңалбай	Оналбай	M
Оңалбек	Оналбек	M
Оңғар	Онгар	M
Оңғарбай	Онгарбай	M
Оңғарсын	Унгарсын	M
Оңдасын	Ондасын	M
Оңтай	Оннтай	M
Опабек	Опабек	M
Опажан	Опажан	F
Ораз	Ораз	M
Ораз	Ураз	M
Оразай	Оразай	M
Оразақ	Оразак	M
Оразақын	Оразакын	M
Оразалы	Оразалы	M
Оразалы	Оразали	M
Оразбай	Оразбай	M
Оразбек	Оразбек	M
Оразгелді	Оразгелди	M
Оразгелді	Оразгельды	M
Оразгүл	Оразгуль	F
Оразғұл	Оразгул	M
Оразиман	Оразиман	M
Оразқан	Оразхан	M
Оразмұқамбет	Оразмухамбет	M
Оразмұхамбет	Оразмухамбет	M
Оразхан	Оразхан	F
Оразша	Оразша	M
Оразымбет	Оразымбет	M
Орақ	Орак	M
Орақбай	Оракбай	M
Орал	Орал	F
Орал	Орал	M
Орал	Урал	M
Оралбай	Оралбай	M
Оралбек	Оралбек	M
Оралтай	Оралтай	M
Оралхан	Оралхан	M
Орасан	Орасан	M
Ораш	Ораш	M
Ордабай	Ордабай	M
Ордан	Ордан	M
Ордәлі	Ордали	M
Орзада	Орзада	F
Орман	Орман	M
Орманбай	Орманбай	M
Орманшы	Орманшы	M
Орша	Орша	F
Орынбай	Орынбай	M
Орынбек	Орынбек	M
Орынғали	Орынгали	M
Орынша	Орынша	F
Осан	Осан	M
Оскар	Оскар	M
Оспан	Оспан	M
Оспанбай	Оспанбай	M
Оспанбек	Оспанбек	M
Оспанғали	Оспангали	M
Оспанәлі	Оспанали	M
Оспантай	Оспантай	M
Оспанхан	Оспанхан	M
Острат	Острат	M
Отан	Отан	M
Отар	Отар	M
Отарбай	Отарбай	M
Ошақбай	Ошакбай	M
Ошан	Ошан	M
Ошар	Ошар	M
Ошқар	Ошкар	M
Өжет	Ожет	M
Өжет	Ужет	M
Өжкен	Ожкен	F
Өзбек	Озбек	M
Өзенбай	Озенбай	M
Өзипа	Озипа	F
Өкім	Оким	M
Өктем	Октем	M
Өктем	Уктем	M
Өлкебай	Олкебай	M
Өмір	Омир	M
Өмір	Умир	M
Өмірбай	Омирбай	M
Өмірбай	Умирбай	M
Өмірбек	Умирбек	M
Өмірғазы	Омиргазы	M
Өмірғали	Омиргали	M
Өмірғали	Умиргали	M
Өміргүл	Омиргуль	F
Өміргүл	Умиргуль	F
Өмірәлі	Умирали	M
Өмірзақ	Омирзак	M
Өмірзақ	Умирзак	M
Өміртай	Умиртай	M
Өмірхан	Умирхан	M
Өмірше	Омирше	F
Өмірше	Умирше	F
Өндіріс	Ондирис	M
Өнеге	Онеге	F
Өнербек	Онербек	M
Өрбике	Орбике	F
Өрбике	Урбике	F
Өрекен	Орекен	M
Өрен	Орен	M
Өрен	Урен	M
Өрзия	Орзия	F
Өрзия	Урзия	F
Өрім	Орим	M
Өрім	Урим	M
Өсер	Осер	M
Өсер	Усер	M
Өсербай	Усербай	M
Өсербек	Усербек	M
Өскенбай	Оскенбай	M
Өскенбай	Ускенбай	M
Өстемір	Устемир	M
Өтебай	Отебай	M
Өтебай	Утебай	M
Өтегали	Отегали	M
Өтеғали	Утегали	M
Өтеген	Отеген	M
Өтеген	Утеген	M
Өтежан	Утежан	M
Өтемағамбет	Отемагамбет	M
Өтемағамбет	Утемагамбет	M
Өтембай	Утембай	M
Өтемғали	Утемгали	M
Өтеміс	Утемис	M
Өтетілеу	Отетилеу	M
Өтетілеу	Утетлеу	M
Пазыл	Пазыл	M
Пазылбек	Пазылбек	M
Палуан	Палуан	M
Палуанғали	Палуангали	M
Палым	Палым	M
Палымбет	Палымбет	M
Пана	Пана	F
Панабек	Панабек	M
Панагул	Панагуль	F
Панаш	Панаш	M
Парасат	Парасат	M
Парасат	Парасат	F
Парзан	Парзан	F
Парсат	Парсат	M
Парық	Парык	M
Пердебек	Пердебек	M
Перизат	Перизат	F
Перузия	Перузия	F
Пәрмен	Пармен	M
Пірәлі	Пирали	M
Пірназар	Пирназар	M
Полымбет	Полымбет	M
Рабат	Рабат	M
Рабия	Рабия	F
Рабқат	Рабкат	M
Радж	Радж	M
Радик	Радик	M
Разақ	Разак	M
Разбай	Разбай	M
Разгүл	Разгуль	F
Разида	Разида	F
Разила	Разила	F
Разима	Разима	F
Разита	Разита	F
Разия	Разия	F
Раиса	Раиса	F
Рай	Рай	M
Райбай	Райбай	M
Райбек	Райбек	M
Райгүл	Райгуль	F
Райкүл	Райгуль	F
Райл	Райл	M
Райма	Райма	F
Райнұр	Райнур	M
Райса	Раиса	F
Райхан	Райхан	F
Райша	Райша	F
Райымбек	Райымбек	M
Райымбек	Раймбек	M
Райыс	Райыс	M
Райыс	Раис	M
Райысқали	Раискали	M
Рақап	Ракап	M
Рақап	Рахап	M
Рақат	Ракат	M
Рақат	Рахат	M
Рақым	Ракым	M
Рақым	Рахим	M
Рақымбай	Рахимбай	M
Рақымбек	Рахимбек	M
Рақымберген	Рахимберген	M
Рақымғали	Рахимгали	M
Рақымжан	Рахимжан	M
Рақыш	Рахиш	M
Рамазан	Рамазан	M
Раман	Раман	M
Рамзия	Рамзия	F
Рамиз	Рамиз	M
Рания	Рания	F
Рапия	Рапия	F
Расима	Расима	F
Расул	Расул	M
Расулбек	Расулбек	M
Рауан	Рауан	M
Рауза	Рауза	F
Рауф	Рауф	M
Раушан	Раушан	F
Раушан	Раушан	M
Рафик	Рафик	M
Рафиқ	Рафих	M
Рафил	Рафиль	M
Рафиха	Рафиха	F
Рахила	Рахила	F
Рахима	Рахима	F
Рахия	Рахия	F
Рахман	Рахман	M
Рахманқұл	Рахманкул	M
Рахмет	Рахмет	M
Рахметолла	Рахметолла	M
Рахметтолла	Рахметулла	M
Рашида	Рашида	F
Рашила	Рашила	F
Рашит	Рашит	M
Рая	Рая	F
Рена	Рена	F
Ренат	Ренат	M
Рената	Рената	F
Рәбиға	Рабига	F
Рәзиза	Разиза	F
Рәзия	Разия	F
Рәш	Раш	F
Рәш	Раш	M
Рәшина	Рашина	F
Риза	Риза	M
Ризабек	Ризабек	M
Рика	Рика	F
Римма	Римма	F
Риммат	Риммат	F
Рита	Рита	F
Ришат	Ришат	M
Роза	Роза	F
Розалия	Розалия	F
Ромат	Ромат	F
Руслан	Руслан	M
Руслана	Руслана	F
Руфа	Руфа	F
Руфия	Руфия	F
Рухигүл	Рухигуль	F
Рухия	Рухия	F
Рүстем	Рустем	M
Рүстембек	Рустембек	M
Рысбек	Рысбек	M
Рыскелді	Рыскелди	M
Сабаз	Сабаз	M
Сабазбек	Сабазбек	M
Сабаншы	Сабаншы	M
Сабатай	Сабатай	M
Сабыр	Сабыр	M
Сабырбек	Сабырбек	M
Сабыржан	Сабыржан	M
Сабыркүл	Сабыркуль	F
Сабырхан	Сабырхан	M
Сағадай	Сагадай	F
Сағадат	Сагадат	M
Сағади	Сагади	M
Сағай	Сагай	M
Сағат	Сагат	M
Сағатай	Сагатай	M
Сағатбай	Сагатбай	M
Сағатбек	Сагатбек	M
Сағди	Сагди	M
Сағи	Саги	M
Сағида	Сагида	F
Сағидолла	Сагидулла	M
Сағила	Сагила	F
Сағира	Сагира	F
Сағит	Сагит	M
Сағия	Сагия	F
Сағым	Сагым	M
Сағын	Сагын	M
Сағын	Сагин	M
Сағынай	Сагинай	M
Сағынғали	Сагингали	M
Сағындық	Сагындык	M
Сағындық	Сагиндык	M
Сағынжан	Сагинжан	F
Сағынжан	Сагинжан	M
Сағынтай	Сагинтай	M
Сағыр	Сагыр	M
Сағыр	Сагир	M
Сағырбай	Сагирбай	M
Садан	Садан	M
Садбен	Садбен	M
Садида	Садида	F
Садыбай	Садыбай	M
Садық	Садык	M
Садықбай	Садыкбай	M
Садықбек	Садыкбек	M
Садыр	Садыр	M
Садырбай	Садырбай	M
Садырбек	Садырбек	M
Саида	Саида	F
Сайбақ	Сайбак	M
Сайда	Сайда	F
Сайдар	Сайдар	M
Сайлар	Сайлар	M
Сайлау	Сайлау	M
Сайлаубай	Сайлаубай	M
Сайлаугүл	Сайлаугуль	F
Саймасай	Саймасай	M
Сайназар	Сайназар	M
Сайра	Сайра	F
Сайрамбай	Сайрамбай	M
Сайран	Сайран	M
Сайранбай	Сайранбай	M
Сайт	Саит	M
Сайым	Саим	M
Сайын	Сайын	M
Сайын	Саин	M
Сайынбек	Саинбек	M
Сайып	Саип	M
Сайыпбек	Саипбек	M
Сайыпназар	Саипназар	M
Сакап	Сакан	F
Сакыман	Сакиман	F
Сакып	Сакып	F
Сакыпжамал	Сақыпжамал	F
Сақтан	Сактан	M
Сақтар	Сактар	M
Сақып	Сакып	F
Сақып	Сакып	M
Сақыпжамал	Сакыпжамал	F
Сақыш	Сакиш	F
Саламат	Саламат	M
Салауат	Салауат	M
Салғара	Салгара	M
Салтай	Салтай	M
Салтанат	Салтанат	F
Салық	Салык	M
Салықбай	Саликбай	M
Салымбай	Салымбай	M
Самал	Самал	F
Самалхан	Самалхан	F
Самарат	Самарат	M
Самарбай	Самарбай	M
Самат	Самат	M
Саматай	Саматай	M
Самға	Самга	M
Самұрат	Самурат	M
Сана	Сана	M
Сана	Сана	F
Санабай	Санабай	M
Санат	Санат	M
Санбай	Санбай	M
Сангерей	Сангерей	M
Сандуғаш	Сандугаш	F
Сандыбай	Сандыбай	M
Санжар	Санжар	M
Сани	Сани	M
Сания	Сания	F
Сансызбай	Сансызбай	M
Сапа	Сапа	M
Сапабай	Сапабай	M
Сапабек	Сапабек	M
Сапақ	Сапак	M
Сапар	Сапар	M
Сапарбай	Сапарбай	M
Сапарбек	Сапарбек	M
Сапарғали	Сапаргали	M
Сапи	Сапи	M
Сара	Сара	F
Сара	Сара	M
Сарбала	Сарбала	M
Сарғасқа	Саргаска	M
Сарғожа	Саргожа	M
Сардар	Сардар	M
Сардарбек	Сардарбек	M
Саржан	Саржан	M
Сари	Сари	M
Сария	Сария	F
Саркен	Саркен	M
Сарқыт	Саркыт	F
Сарқытгүл	Саркытгуль	F
Сарман	Сарман	M
Сармантай	Сармантай	M
Сармат	Сармат	M
Сартай	Сартай	M
Сары	Сары	M
Сарыбай	Сарыбай	M
Сарыбас	Сарыбас	M
Сарық	Сарик	M
Сарын	Сарын	M
Сасан	Сасан	M
Сатай	Сатай	M
Саттар	Саттар	M
Сатыбалды	Сатыбалды	M
Сатыбек	Сатыбек	M
Сатымжан	Сатимжан	M
Сауғабай	Саугабай	M
Сауран	Сауран	M
Сауранбай	Сауранбай	M
Сауранбек	Сауранбек	M
Саурық	Саурык	M
Сауық	Сауык	M
Сауық	Саук	M
Сауыт	Сауыт	M
Сауытбай	Сауытбай	M
Сафа	Сафа	M
Сафи	Сафи	M
Сафуан	Сафуан	M
Сафура	Сафура	F
Сахи	Сахи	M
Сахима	Сахима	F
Сая	Сая	M
Саяжан	Саяжан	M
Саян	Саян	M
Саятқан	Саяткан	M
Саятқан	Саятхан	M
Света	Света	F
Светлана	Светлана	F
Сезім	Сезим	M
Сеидазым	Сейдазим	M
Сейдаз	Сейдаз	M
Сейдахмет	Сейдахмет	M
Сейдехан	Сейдехан	M
Сейдәлі	Сейдали	M
Сейділда	Сейдилда	M
Сейділда	Сейдильда	M
Сейдімбек	Сейдимбек	M
Сейдін	Сейдин	M
Сейдолла	Сейдолла	M
Сейдрахман	Сейдрахман	M
Сейдуәли	Сейдуали	M
Сейіл	Сейил	M
Сейіл	Сеиль	M
Сейілбек	Сеильбек	M
Сейілжан	Сеильжан	M
Сейіт	Сейит	M
Сейіт	Сеит	M
Сейітбаттал	Сеитбаттал	M
Сейітбек	Сеитбек	M
Сейітәлі	Сеитали	M
Сейітжан	Сеитжан	M
Сейіткемел	Сеиткемель	M
Сейітқазы	Сейтхазы	M
Сейітмет	Сейитмет	M
Сейітмұрат	Сеитмурат	M
Сейітназар	Сейтназар	M
Сейітхан	Сейтхан	M
Сейсенбай	Сейсенбай	M
Сейсенбек	Сейсенбек	M
Сейтек	Сейтек	M
Сейтен	Сейтен	M
Сейтімбет	Сейтимбет	M
Сейфолла	Сейфолла	M
Сейфолла	Сейфулла	M
Секен	Секен	M
Сексенбай	Сексенбай	M
Сембай	Сембай	M
Сембек	Сембек	M
Сембет	Сембет	M
Сембі	Семби	M
Сементей	Сементей	M
Сенім	Сеним	M
Сеңгірбай	Сенгирбай	M
Сербота	Сербота	M
Серғазы	Сергазы	M
Серғали	Сергали	M
Серғалы	Сергали	M
Серәлі	Серали	M
Сержан	Сержан	M
Серік	Серик	M
Серікбай	Серикбай	M
Серікбек	Серикбек	M
Серікбол	Серикбол	M
Серікәлі	Серикали	M
Серікжан	Серикжан	M
Серікқали	Сериккали	M
Серке	Серке	M
Серкебай	Серкебай	M
Сермағамбет	Сермагамбет	M
Сертай	Сертай	M
Сәбиға	Сабига	F
Сәбиғат	Сабигат	M
Сәбила	Сабила	F
Сәбира	Сабира	F
Сәбит	Сабит	M
Сәбитбек	Сабитбек	M
Сәбитхан	Сабитхан	M
Сәден	Саден	M
Сәді	Сади	M
Сәдібек	Садибек	M
Сәду	Саду	M
Сәдуақас	Садуакас	M
Сәжида	Сажида	F
Сәйкі	Сайки	M
Сәкен	Сакен	M
Сәли	Сали	M
Сәлима	Салима	F
Сәлиман	Салиман	F
Сәлиха	Салиха	F
Сәлім	Салим	M
Сәлімбай	Салимбай	M
Сәлімбек	Салимбек	M
Сәлімжан	Салимжан	M
Сәлкен	Салкен	M
Сәлмен	Салмен	M
Сәмен	Самен	M
Сәмет	Самет	M
Сәми	Сами	M
Сәмия	Самия	F
Сән	Сан	F
Сәнәмай	Санамай	F
Сәнида	Санида	F
Сәнипа	Санипа	F
Сәния	Сания	F
Сәнімай	Санимай	F
Сәнтай	Сантай	M
Сәпина	Сапина	F
Сәпі	Сапи	M
Сәрсек	Сарсек	M
Сәрсекей	Сарсекей	M
Сәрсен	Сарсен	M
Сәрсенбай	Сарсенбай	M
Сәрсенбі	Сарсенби	M
Сәруар	Саруар	F
Сәт	Сат	M
Сәтбай	Сатбай	M
Сәтбек	Сатбек	M
Сәтен	Сатен	F
Сәтжан	Сатжан	M
Сәтібек	Сатибек	M
Сәтім	Сатим	M
Сәтке	Сатке	M
Сәттібай	Саттибай	M
Сәттіғұл	Саттигул	M
Сәуір	Сауир	M
Сәуірбай	Саурбай	M
Сәуірбек	Саурбек	M
Сәуле	Сауле	F
Сәулебай	Саулебай	M
Сәулебек	Саулебек	M
Сәулет	Саулет	F
Сәулет	Саулет	M
Симақ	Симак	M
Сираж	Сираж	M
Сиран	Сиран	M
Сиязбай	Сиязбай	M
Совет	Совет	M
Советбек	Советбек	M
Советжан	Советжан	M
Советияр	Советияр	M
Сократ	Сократ	M
Соқпақбай	Сокпакбай	M
Солдатбек	Солдатбек	M
Солтанай	Солтанай	M
Солты	Солты	M
Солтыбай	Солтыбай	M
Сомбел	Сомбел	M
Сомбел	Сомбель	M
Соня	Соня	F
София	София	F
Стамбақы	Стамбаки	M
Стамбек	Стамбек	M
Сухамбай	Сухамбай	M
Сухамберді	Сухамберди	M
Сүгір	Сугир	M
Сүгірбай	Сугирбай	M
Сүйінбай	Суюнбай	M
Сүйінбала	Суиинбала	F
Сүйеу	Суйеу	M
Сүйімхан	Суюмхан	F
Сүйін	Суйин	M
Сүйінбай	Суйинбай	M
Сүйінбала	Суюнбала	F
Сүйіншәлі	Суюншали	M
Сүйрік	Суйрик	F
Сүлеймен	Сулеймен	M
Сүмбебай	Сумбебай	M
Сүмбіл	Сумбиль	F
Сүндет	Сундет	M
Сүткенже	Суткенже	F
Сүттібай	Суттибай	M
Сұлтан	Султан	M
Сұлтанбай	Султанбай	M
Сұлтанбек	Султанбек	M
Сұлтанғазы	Султангазы	M
Сұлтанғали	Султангали	M
Сұлтангелді	Султангелди	M
Сұлтангелді	Султангельды	M
Сұлтания	Султанья	M
Сұлтанмұрат	Султанмурат	M
Сұлу	Сулу	F
Сұлуке	Сулуке	F
Сұлуман	Сулуман	F
Сұлухан	Сулухан	F
Сұлушаш	Сулушаш	F
Сұңқар	Сункар	M
Сұраған	Сураган	M
Сыбанбай	Сыбанбай	M
Сыбанқұл	Сыбанкул	M
Сығай	Сигай	M
Сыдық	Сыдык	M
Сыздық	Сыздык	M
Сыйқым	Сихим	M
Сыйық	Сыик	M
Сылан	Сылан	M
Сымайыл	Смаил	M
Сымақ	Сымак	M
Сымат	Смат	M
Сыматай	Сматай	M
Сымахан	Смахан	M
Сымбат	Сымбат	F
Сындыбай	Сындыбай	M
Сындыбала	Сындыбала	F
Сыпатай	Сыпатай	M
Сыражы	Сражи	M
Сырбай	Сырбай	M
Сырға	Сырга	F
Сырғабай	Сыргабай	M
Сырғабек	Сыргабек	M
Сырғалы	Сыргалы	F
Сырлыбай	Сырлыбай	M
Сырлыбек	Сырлыбек	M
Сырмұхамбет	Сырмухамбет	M
Сырым	Сырым	M
Сырымбет	Сырымбет	M
Табар	Табар	M
Табат	Табат	M
Табыл	Табыл	M
Табылған	Табылган	M
Табылды	Табылды	M
Табыс	Табыс	M
Тағай	Тагай	M
Тағаш	Тагаш	M
Тадғатбек	Талгатбек	M
Тазабек	Тазабек	M
Тайбала	Тайбала	F
Тайбек	Тайбек	M
Тайжан	Тайжан	M
Тайлақ	Тайлак	M
Тайламбек	Тайламбек	M
Тайман	Тайман	M
Таймас	Таймас	M
Тайшат	Тайшат	M
Тайшық	Тайшык	M
Тайымбет	Таимбет	M
Тайыр	Тайыр	M
Тайыр	Таир	M
Тақыр	Такыр	M
Талап	Талап	M
Талапбек	Талапбек	M
Талғар	Талгар	M
Талғат	Талгат	M
Талжан	Талжан	F
Талжан	Талжан	M
Талқа	Талка	M
Талмас	Талмас	M
Талшыбық	Талшыбык	F
Талшыбық	Талшибык	F
Талшын	Талшын	F
Тама	Тама	F
Тама	Тама	M
Тамабай	Тамабай	M
Тамара	Тамара	F
Тамаша	Тамаша	F
Тана	Тана	F
Танабай	Танабай	M
Танагүл	Танагуль	F
Танап	Танап	M
Танапбай	Танапбай	M
Танаш	Танаш	M
Таңат	Танат	M
Таңатар	Танатар	M
Таңбол	Танбол	M
Таңжарық	Танжарык	M
Таңжас	Танжас	M
Таңқар	Танкар	M
Таңсар	Тансар	M
Таңсық	Тансык	F
Таңсық	Тансык	M
Таңсықбай	Тансыкбай	M
Таңшолпан	Таншолпан	F
Таһир	Тахир	M
Тапар	Тапар	M
Тарас	Тарас	M
Тарғын	Таргын	M
Тасай	Тасай	M
Тасан	Тасан	M
Тасанбай	Тасанбай	M
Тасбала	Тасбала	F
Тасболат	Тасболат	M
Тасемен	Тасемен	M
Тасжігер	Тасжигер	M
Таскен	Таскен	M
Тасқайрат	Таскайрат	M
Тасқын	Таскын	M
Таслима	Таслима	F
Тасмағамбет	Тасмагамбет	M
Тасмұқан	Тасмукан	M
Тастай	Тастай	M
Тастайбек	Тастайбек	M
Тастан	Тастан	M
Тастанбек	Тастанбек	M
Тастемір	Тастемир	M
Тастүлек	Тастулек	M
Тасыбек	Тасыбек	M
Тасым	Тасым	M
Татен	Татен	M
Татубай	Татубай	M
Тау	Тау	M
Тауан	Тауан	M
Тауасат	Тауасат	M
Таубай	Таубай	M
Таужан	Таужан	M
Таужат	Таужат	M
Таукен	Таукен	M
Таукеш	Таукеш	M
Тауман	Тауман	M
Таутан	Таутан	M
Тауфих	Тауфих	M
Таушы	Тауши	M
Тахауи	Тахауи	M
Тегеран	Тегеран	M
Тегіс	Тегис	M
Телғожа	Тельхожа	M
Телжан	Тельжан	M
Тельман	Тельман	M
Темір	Темир	M
Темірбай	Темирбай	M
Темірбек	Темирбек	M
Темірболат	Темирболат	M
Темірғали	Темиргали	M
Темірәлі	Темирали	M
Темірқан	Темиркан	M
Темірлан	Темирлан	M
Теміртас	Темиртас	M
Теміртүлек	Темиртулек	M
Темірхан	Темирхан	M
Теңдік	Тендик	F
Теңізбай	Тенизбай	M
Теңізбай	Тенгизбай	M
Тәбиба	Табиба	F
Тәбила	Табила	F
Тәбия	Табия	F
Тәжі	Тажи	M
Тәжібай	Тажибай	M
Тәжігүл	Тажигуль	F
Тәжімбет	Тажимбет	M
Тәжіхан	Тажихан	F
Тәйкен	Тайкен	F
Тәкен	Такен	M
Тәкібай	Такибай	M
Тәкім	Таким	M
Тәлима	Талима	F
Тәлина	Талина	F
Тәлипа	Талипа	F
Тәлім	Талим	F
Тәлім	Талим	M
Тәлімғыз	Талимгыз	F
Тәліп	Талип	M
Тәмила	Тамила	F
Тәмина	Тамина	F
Тәнеке	Танеке	M
Тәнзила	Танзила	F
Тәнзия	Танзия	F
Тәниза	Таниза	F
Тәңірбай	Танирбай	M
Тәңірберген	Танирберген	M
Тәрбие	Тарбие	F
Тәрбие	Тарбия	F
Тәтен	Татен	M
Тәтипа	Татипа	F
Тәтті	Татти	F
Тәттібай	Таттибай	M
Тәттібала	Таттибала	F
Тәттігүл	Таттигуль	F
Тәттіғыз	Таттигыз	F
Тәттімбет	Таттимбет	M
Тәуекел	Тауекел	M
Тәуір	Тауир	M
Тәуір	Таур	M
Тәуірбек	Таурбек	M
Тәуке	Тауке	M
Тәукен	Таукен	M
Тәшен	Ташен	M
Тиес	Тиес	M
Тимур	Тимур	M
Тиянақ	Тиянак	M
Тілебалды	Тлебалды	M
Тілеген	Тилеген	M
Тілеген	Тлеген	M
Тілек	Тилек	M
Тілек	Тлек	M
Тілектес	Тлектес	M
Тілеміс	Тилемис	M
Тілепбай	Тлепбай	M
Тілепберген	Тлепберген	M
Тілеубай	Тлеубай	M
Тілеужан	Тлеужан	M
Тілеуке	Тлеуке	M
Тілеулі	Тлеули	M
Тілеумұрат	Тлеумурат	M
Тілеухан	Тлеухан	M
Тілменбай	Тилменбай	M
Тоғанас	Тоганас	M
Тоғжан	Тогжан	F
Тоғжігіт	Тогжигит	M
Тоғұзақ	Тогузак	M
Тоғызақ	Тогызак	M
Тоғызбай	Тогызбай	M
Тоғысбай	Тогысбай	M
Тойбазар	Тойбазар	M
Тойбай	Тойбай	M
Тойбала	Тойбала	F
Тойбике	Тойбике	F
Тойболды	Тойболды	M
Тойған	Тойган	M
Тойғанбай	Тойганбай	M
Тойғанбек	Тойганбек	M
Тойшы	Тойши	M
Тоқа	Тока	M
Тоқай	Токай	M
Тоқан	Токан	M
Тоқас	Токас	M
Тоқатай	Токатай	M
Тоқбай	Токбай	M
Тоқберген	Токберген	M
Тоқмағамбет	Токмагамбет	M
Тоқмұқамбет	Токмухамбет	M
Тоқмырза	Токмурза	M
Тоқпан	Токпан	M
Тоқсаба	Токсаба	M
Тоқсан	Токсан	M
Тоқсанбай	Токсанбай	M
Тоқсұлу	Токсулу	F
Тоқтағали	Токтагали	M
Тоқтаған	Токтаган	M
Тоқтамыс	Токтамыс	M
Тоқтар	Токтар	M
Тоқтар	Тохтар	M
Тоқтарбай	Тохтарбай	M
Тоқтарғали	Тохтаргали	M
Тоқтарқан	Тохтархан	M
Тоқтасын	Токтасын	M
Тоқтыбай	Токтыбай	M
Тоқыр	Токыр	M
Толағай	Толагай	M
Толай	Толай	M
Толғанай	Толганай	F
Толқын	Толкын	F
Толман	Толман	M
Толтан	Толтан	M
Толыбай	Толыбай	M
Толыбек	Толыбек	M
Толымбет	Толымбет	M
Толыс	Толыс	M
Толысбала	Толысбала	F
Толыш	Толыш	F
Томан	Томан	M
Торғай	Тургай	M
Торғын	Торгын	F
Торжан	Торжан	F
Торламбай	Торламбай	M
Торпак	Торпак	M
Торсан	Торсан	M
Тортай	Тортай	M
Торымбала	Торымбала	F
Торымжан	Торымжан	F
Тотай	Тотай	M
Тотия	Тотия	F
Тоты	Тоты	F
Тотығұс	Тотыгус	F
Тояш	Тояш	F
Төбей	Тобей	M
Төкен	Токен	M
Төлбай	Толбай	M
Төлбай	Тольбай	M
Төлғожа	Толгожа	M
Төлебай	Толебай	M
Төлеген	Тулеген	M
Төлек	Тулек	M
Төлекей	Тулекей	M
Төлепкали	Тулепкали	M
Төлжан	Тольжан	M
Төребай	Туребай	M
Төребек	Торебек	M
Төребек	Туребек	M
Төрегелді	Турегельды	M
Төрежан	Турежан	M
Төрехан	Торехан	M
Төрехан	Турехан	M
Туғанбай	Туганбай	M
Тулек	Тулек	M
Турабай	Турабай	M
Турашыл	Турашил	M
Түбек	Тубек	M
Түгелбай	Тугелбай	M
Түймехан	Туймехан	F
Түлек	Тулек	M
Түлкібай	Тулкибай	M
Түмен	Тумен	M
Түменбай	Туменбай	M
Түргенбай	Тургенбай	M
Түрке	Турке	M
Түркеш	Туркеш	M
Түсен	Тусен	M
Түсіп	Тусип	M
Түсіп	Тусуп	M
Түсіпжан	Тусипжан	M
Тұлымхан	Тулымхан	F
Тұмарбай	Тумарбай	M
Тұмарбек	Тумарбек	M
Тұмаржан	Тумаржан	M
Тұмарша	Тумарша	F
Тұңғатар	Тунгатар	M
Тұңғышбай	Тунгишбай	M
Тұрап	Турап	M
Тұрапбай	Турапбай	M
Тұратай	Туратай	F
Тұрахан	Турахан	F
Тұраш	Тураш	M
Тұрбек	Турбек	M
Тұрған	Турган	F
Тұрғанай	Турганай	F
Тұрғанбек	Турганбек	M
Тұрғангүл	Тургангуль	F
Тұрғат	Тургат	M
Тұрғын	Тургун	M
Тұрғын	Тургын	M
Тұрғынбай	Тургинбай	M
Тұрғынбек	Тургинбек	M
Тұрдалы	Турдали	M
Тұрдыбек	Турдыбек	M
Тұрлыбай	Турлыбай	M
Тұрмағамбет	Турмагамбет	M
Тұрманжан	Турманжан	M
Тұрсын	Турсын	M
Тұрсын	Турсун	M
Тұрсынай	Турсынай	F
Тұрсынбай	Турсынбай	M
Тұрсынбек	Турсынбек	M
Тұрсынбек	Турсунбек	M
Тұрсынгүл	Турсынгуль	F
Тұрсынжан	Турсынжан	M
Тұрсынжан	Турсунжан	M
Тұрсынхан	Турсынхан	F
Тұрымтай	Турымтай	M
Тұрымхан	Турымхан	F
Тұрыс	Турыс	M
Тұрысбек	Турысбек	M
Тұяк	Туяк	M
Тұяқбай	Туякбай	M
Тыйышбек	Тиышбек	M
Тыналы	Тыналы	M
Тыналы	Тнали	M
Тыныбай	Тыныбай	M
Тыныбек	Тыныбек	M
Тыным	Тыным	M
Тынымбай	Тынымбай	M
Тыныс	Тыныс	M
Тынысбай	Тынысбай	M
Тыныстан	Тыныстан	M
Тынышгүл	Тынышгуль	F
Тыныштығұл	Тыныштыгул	M
Тыныштық	Тыныштык	M
Тыныштықбек	Тыныштыкбек	M
Уайда	Уайда	M
Уайыс	Уайыс	M
Уайыс	Уаис	M
Уақап	Уакап	M
Уанбай	Уанбай	M
Уандық	Уандык	M
Уатай	Уатай	M
Уахап	Уахап	M
Уахат	Уахат	M
Уахит	Уахит	M
Уәзипа	Уазипа	F
Уәйқан	Уайхан	M
Уәли	Уали	M
Уәлиахмет	Уалиахмет	M
Уәлит	Уалит	M
Уәсила	Уасила	F
Уәсима	Уасима	F
Уса	Уса	M
Усабай	Усабай	M
Усабек	Усабек	M
Уфа	Уфа	M
Уықбай	Уыкбай	M
Үбайда	Убайда	F
Үббі	Убби	M
Үбияна	Убияна	F
Үдербай	Удербай	M
Үдері	Удери	M
Үкі	Уки	M
Үлгібай	Улгибай	M
Үлгібай	Ульгибай	M
Үмбет	Умбет	M
Үмбетбай	Умбетбай	M
Үмбетәлі	Умбетали	M
Үмбетжан	Умбетжан	M
Үмігүлсім	Умигульсим	F
Үміт	Умит	F
Үміт	Умит	M
Үмітай	Умитай	F
Үмітан	Умитан	F
Үмітбай	Умитбай	M
Үмітжан	Умитжан	F
Үргенішбай	Ургенишбай	M
Үржәпия	Уржапия	F
Үрзия	Урзия	F
Үрипан	Урипан	F
Үрия	Урия	F
Үрімбай	Уримбай	M
Үрімжан	Уримжан	M
Үрімқан	Уримхан	M
Үртай	Уртай	M
Үсебай	Усебай	M
Үсен	Усен	M
Үсенбай	Усенбай	M
Үсенбек	Усенбек	M
Үсенғали	Усенгали	M
Үсіпбек	Усипбек	M
Үстем	Устем	M
Ұзақ	Узак	M
Ұзақбай	Узакбай	M
Ұиықбай	Уюкбай	M
Ұйықбай	Уйыкбай	M
Ұлан	Улан	M
Ұлас	Улас	M
Ұлбала	Улбала	F
Ұлбибі	Улбиби	F
Ұлбике	Улбике	F
Ұлғай	Улгай	M
Ұлғанай	Улганай	F
Ұлда	Улда	F
Ұлдай	Улдай	F
Ұлдан	Улдан	F
Ұлдыш	Улдыш	F
Ұлжан	Улжан	F
Ұлмақан	Улмакан	M
Ұлпа	Улпа	F
Ұлпан	Улпан	F
Ұлпанай	Улпанай	F
Ұлтыбай	Ултубай	M
Ұлфат	Улфат	F
Ұлхан	Улхан	F
Ұлшым	Улшим	F
Ұлық	Улук	M
Ұлықбек	Улыкбек	M
Ұлықбек	Улукбек	M
Ұлымбет	Улумбет	M
Ұмсын	Умсын	F
Ұмсынай	Умсынай	F
Ұмсындық	Умсындык	F
Ұрзада	Урзада	F
Ұрзия	Урзия	F
Ұрқия	Уркия	F
Фазила	Фазила	F
Фазия	Фазия	F
Фазыл	Фазыл	M
Файзи	Файзи	M
Файзолла	Файзулла	M
Файзрахман	Файзрахман	M
Файыз	Файыз	M
Фарид	Фарид	M
Фарида	Фарида	F
Фариза	Фариза	F
Фаруза	Фаруза	F
Фархат	Фархат	M
Фатима	Фатима	F
Фатих	Фатих	M
Фатхолла	Фатхулла	M
Фаузия	Фаузия	F
Фахир	Фахир	M
Фахыр	Фахир	M
Феликс	Феликс	M
Фироза	Фироза	F
Фируза	Фируза	F
Флора	Флора	F
Фурқат	Фуркат	M
Хаби	Хаби	M
Хабиб	Хабиб	M
Хабиба	Хабиба	F
Хабиболла	Хабибулла	M
Хадим	Хадим	M
Хадиша	Хадиша	F
Хадия	Хадия	F
Хаіттемір	Хантемир	M
Хайдар	Хайдар	M
Хайрия	Хайрия	F
Хайролла	Хайрулла	M
Хайша	Хайша	F
Хакім	Хаким	M
Хакімбек	Хакимбек	M
Хакімжан	Хакимжан	M
Хақназар	Хакназар	M
Халаби	Халаби	M
Халел	Халел	M
Халид	Халид	M
Халида	Халида	F
Халил	Халил	M
Халила	Халила	F
Халима	Халима	F
Халиса	Халиса	F
Халық	Халык	M
Халықбай	Халыкбай	M
Хамза	Хамза	M
Хамит	Хамит	M
Хаммат	Хаммат	M
Ханбек	Ханбек	M
Ханболат	Ханболат	M
Ханғали	Хангали	M
Хангелді	Хангелди	M
Хангелді	Хангельды	M
Ханифа	Ханифа	F
Хантемір	Хантемир	M
Харес	Харес	M
Хасан	Хасан	M
Хасен	Хасен	M
Хасипа	Хасипа	F
Хатима	Хатима	F
Хатип	Хатип	M
Хатипа	Хатипа	F
Хатиф	Хатиф	M
Хафиз	Хафиз	M
Хафиза	Хафиза	F
Хикмет	Хикмет	M
Хусайын	Хусайн	M
Хұсайын	Хусайын	M
Шабай	Шабай	M
Шабақ	Шабак	M
Шабал 	Шабал	F
Шабдан	Шабдан	M
Шағила 	Шагила	F
Шағыр	Шагыр	M
Шағыр	Шагир	M
Шадыман	Шадыман	M
Шадыман	Шадман	M
Шажабек	Шажабек	M
Шайбала 	Шайбала	F
Шайбан	Шайбан	M
Шайбек	Шайбек	M
Шайгүл 	Шайгуль	F
Шайдар	Шайдар	M
Шайдарбек	Шайдарбек	M
Шайдахмет	Шайдахмет	M
Шайжан	Шайжан	M
Шайзада 	Шайзада	F
Шаймерден	Шаймерден	M
Шайнұр	Шайнур	M
Шайхан	Шайхан	M
Шайхы	Шайхы	M
Шайхы	Шайхи	M
Шакарім	Шакарим	M
Шақабай	Шахабай	M
Шалабай	Шалабай	M
Шалахмет	Шалахмет	M
Шалдыбай	Шалдыбай	M
Шалқар	Шалкар	M
Шалқарбай	Шалкарбай	M
Шам	Шам	M
Шамат	Шамат	M
Шамбыл	Шамбыл	M
Шамғон	Шамгон	M
Шамгүл 	Шамгуль	F
Шамел	Шамел	M
Шамен	Шамен	M
Шамжан	Шамжан	M
Шами	Шами	M
Шамис	Шамис	M
Шамұрат	Шамурат	M
Шамша 	Шамша	F
Шамшат	Шамшат	M
Шаңғытбай	Шангитбай	M
Шапағат	Шапагат	M
Шапай	Чапай	M
Шапақ	Шапак	M
Шапшақ	Шапшак	M
Шара	Шара	F
Шара 	Шара	F
Шарабас	Шарабас	M
Шарапа 	Шарапа	F
Шарапат	Шарапат	F
Шарапат	Шарапат	M
Шарапат 	Шарапат	F
Шарапия 	Шарапия	F
Шара-Шырынгүл	Шара-Шырынгуль	F
Шарбану	Шарбану	F
Шарбану 	Шарбану	F
Шартай	Шартай	M
Шарыбай	Шарибай	M
Шарықбек	Шарыкбек	M
Шатан	Шатан	M
Шаткерім	Шаткерим	M
Шаттыгүл	Шаттыгуль	F
Шаттық	Шаттык	M
Шаужан	Шаужан	M
Шафиға	Шафига	F
Шафиқ	Шафик	M
Шафих	Шафих	M
Шафқат	Шафкат	M
Шафхат	Шафхат	M
Шахаман	Шахаман	M
Шахан	Шахан	M
Шахар	Шахар	M
Шахарбай	Шахарбай	M
Шахахмет	Шахахмет	M
Шахзада	Шахзада	F
Шахида	Шахида	F
Шахия	Шахия	F
Шахмардан	Шахмардан	M
Шахмұрат	Шахмурат	M
Шахмұхамбет	Шахмухамбет	M
Шахназар	Шахназар	M
Шашубай	Шашубай	M
Шаяхмет	Шаяхмет	M
Шеге	Шеге	M
Шегебай	Шегебай	M
Шекер	Шекер	F
Шекербек	Шекербек	M
Шектібай	Шектыбай	M
Шер	Шер	M
Шерғали	Шергали	M
Шерәлі	Шерали	M
Шери	Шери	M
Шерімбек	Шеримбек	M
Шермұхамбет	Шермухамбет	M
Шернияз	Шернияз	M
Шерубай	Шерубай	M
Шерхан	Шерхан	M
Шәден	Шаден	M
Шәді	Шади	M
Шәйдолла	Шайдулла	M
Шәйкен	Шайкен	M
Шәкен	Шакен	M
Шәкәрім	Шакарим	M
Шәкиза	Шакиза	F
Шәкира	Шакира	F
Шәкізат	Шакизат	F
Шәкір	Шакир	M
Шәкірбек	Шакирбек	M
Шәкура	Шакура	F
Шәлгез	Шалгез	M
Шәлдибек	Шалдибек	M
Шәлипа	Шалипа	F
Шәмен	Шамен	M
Шәми	Шами	M
Шәміл	Шамиль	M
Шәмкен	Шамкен	M
Шәмсия	Шамсия	F
Шәмши	Шамши	M
Шәмшия	Шамшия	F
Шәни	Шани	M
Шәният	Шаният	M
Шәпи	Шапи	M
Шәрбат	Шарбат	F
Шәризат	Шаризат	M
Шәрипа	Шарипа	F
Шәріп	Шарип	M
Шәріпбай	Шарипбай	M
Шәріпбек	Шарипбек	M
Шәріпхан	Шарипхан	M
Шәукен	Шаукен	M
Шәукенбай	Шаукенбай	M
Шияб	Шияб	M
Шілдебай	Шилдебай	M
Шілдебай	Чильдебай	M
Шілдебай	Шильдебай	M
Шойбек	Шойбек	M
Шойман	Шойман	M
Шокан	Чокан	M
Шоқы	Шокы	M
Шоқыр	Шокыр	M
Шолан	Чулан	M
Шолан	Шолан	M
Шолман	Шолман	M
Шолпан	Шолпан	F
Шолпанай	Шолпанай	F
Шолпанбай	Шолпанбай	M
Шолпанбек	Шолпанбек	M
Шомбал	Шомбал	M
Шомбек	Шомбек	M
Шона	Шона	M
Шонбай	Шонбай	M
Шоң	Шон	M
Шопан	Шопан	M
Шора	Шора	M
Шорабай	Шорабай	M
Шорабек	Шорабек	M
Шорман	Шорман	M
Шортанбай	Шортанбай	M
Шота	Шота	M
Шотай	Шотай	M
Шотан	Шотан	M
Шотбай	Шотбай	M
Шөже	Чуже	M
Шөже	Шоже	M
Шүкір	Шукир	M
Шүкірбай	Шукирбай	M
Шүкірбек	Шукирбек	M
Шүкірәлі	Шукирали	M
Шұға	Шуга	F
Шығай	Шыгай	M
Шығай	Шигай	M
Шығанақ	Шыганак	M
Шығанақ	Чиганак	M
Шығанақ	Шиганак	M
Шыман	Шман	M
Шымыр	Шымыр	M
Шымыр	Чимыр	M
Шымыр	Шимыр	M
Шыналы	Чинали	M
Шыналы	Шынали	M
Шынар	Шынар	F
Шынаргүл	Шынаргуль	F
Шынасыл	Шинасыл	M
Шынболат	Чинболат	M
Шынболат	Шынболат	M
Шынғали	Чингали	M
Шынғали	Шынгали	M
Шындалы	Чиндали	M
Шындалы	Шындали	M
Шындәулет	Чиндавлет	M
Шындәулет	Шындаулет	M
Шынтас	Чинтас	M
Шынтас	Шынтас	M
Шынтемір	Шынтемир	M
Шынтемір	Чинтемир	M
Шынтілеу	Чинтлеу	M
Шынтілеу	Шынтлеу	M
Шыныбай	Чинибай	M
Шыныбай	Шыныбай	M
Шыныбек	Чинибек	M
Шыныбек	Шыныбек	M
Шыңғыс	Чингис	M
Шырай	Шырай	F
Шырайгүл	Шырайгуль	F
Шырақбек	Шыракбек	M
Шырғали	Шыргали	M
Шырын	Шырын	F
Шырынгүл	Шырынгуль	F
Ыбырай	Ыбырай	M
Ыбырай	Ибрай	M
Ыбырайым	Ибраим	M
Ыбыраш	Ибраш	M
Ыдырыс	Ыдырыс	M
Ыдырыс	Идрис	M
Ықсан	Ыксан	M
Ықсан	Ихсан	M
Ықылас	Ыкылас	M
Ықылас	Ихлас	M
Ынтыбай	Интыбай	M
Ынтыбай	Ынтыбай	M
Ынтызар	Ынтызар	M
Ынтызар	Интызар	M
Ынтық	Интык	M
Ынтық	Ынтык	M
Ынтықбай	Интыкбай	M
Ынтықбай	Ынтыкбай	M
Ынтымақ	Ынтымак	M
Ырзабай	Рзабай	M
Ырзабек	Ырзабек	M
Ырым	Рым	M
Ырымбай	Рымбай	M
Ырымбек	Рымбек	M
Ырымет	Рымет	M
Ырымқұл	Рымкул	M
Ырыс	Рыс	M
Ырысалды	Ырысалды	F
Ырысалды	Ырысалды	M
Ырысалды	Рсалды	M
Ырысалды	Рысалды	M
Ырысбай	Рысбай	M
Ырысбала	Ырысбала	F
Ырысбала	Рысбала	F
Ырысбек	Ырысбек	M
Ырысбек	Рысбек	M
Ырысберген	Рысберген	M
Ырысжан	Рысжан	M
Ырыскелді	Рыскелды	M
Ырыскүл	Рысгуль	F
Ырысқұл	Рыскул	M
Ырысты	Ырысты	F
Ырысты	Рысты	F
Ырысхан	Рысхан	F
Ысқақ	Ыскак	M
Ысқақ	Искак	M
Ысқақбай	Искакбай	M
Ысмағұл	Исмагул	M
Ысмайыл	Исмаил	M
Ысмақан	Смахан	M
Ысмат	Смат	M
Ысматбек	Сматбек	M
Ыспан	Спан	M
Ыспандияр	Спандияр	M
Ыстамбақы	Ыстамбакы	M
Эдуарт	Эдуард	M
Элеонора	Элеонора	F
Элла	Элла	F
Эльбрус	Эльбрус	M
Эльвира	Эльвира	F
Эмиль	Эмиль	M
Эмма	Эмма	F
Эра	Эра	F
Эрнест	Эрнест	M
